popularity,original_title,runtime,genres,release_year,budget_adj,revenue_adj,profit
32,Jurassic World,124,Action|Adventure|Science Fiction|Thriller,2015,137999939,1392445893,1254445954
28,Mad Max: Fury Road,120,Action|Adventure|Science Fiction|Thriller,2015,137999939,348161292,210161353
13,Insurgent,119,Adventure|Science Fiction|Thriller,2015,101199955,271619025,170419070
11,Star Wars: The Force Awakens,136,Action|Adventure|Science Fiction|Fantasy,2015,183999919,1902723130,1718723211
9,Furious 7,137,Action|Crime|Thriller,2015,174799923,1385748801,1210948878
9,The Revenant,156,Western|Drama|Adventure|Thriller,2015,124199945,490314247,366114302
8,Terminator Genisys,125,Science Fiction|Action|Thriller|Adventure,2015,142599937,405355075,262755138
7,The Martian,141,Drama|Adventure|Science Fiction,2015,99359956,547749654,448389698
7,Minions,91,Family|Animation|Adventure|Comedy,2015,68079970,1064192017,996112047
6,Inside Out,94,Comedy|Animation|Family,2015,160999929,785411574,624411645
6,Spectre,148,Action|Adventure|Crime,2015,225399900,810220283,584820383
6,Jupiter Ascending,124,Science Fiction|Fantasy|Action|Adventure,2015,161919931,169268630,7348699
6,Ex Machina,108,Drama|Science Fiction,2015,13799993,33919845,20119852
5,Pixels,105,Action|Comedy|Science Fiction,2015,80959964,224146025,143186061
5,Avengers: Age of Ultron,141,Action|Adventure|Science Fiction,2015,257599886,1292632337,1035032451
5,The Hateful Eight,167,Crime|Drama|Mystery|Western,2015,40479982,143299244,102819262
5,Taken 3,109,Crime|Action|Thriller,2015,44159980,299709578,255549598
5,Ant-Man,115,Science Fiction|Action|Adventure,2015,119599947,477113780,357513833
5,Cinderella,112,Romance|Fantasy|Family|Drama,2015,87399961,498963025,411563064
5,The Hunger Games: Mockingjay - Part 2,136,War|Adventure|Science Fiction,2015,147199935,598481289,451281354
5,Tomorrowland,130,Action|Family|Science Fiction|Adventure|Mystery,2015,174799923,192312729,17512806
5,Southpaw,123,Action|Drama,2015,27599987,84373003,56773016
4,San Andreas,114,Action|Drama|Thriller,2015,101199955,432851375,331651420
4,Fifty Shades of Grey,125,Drama|Romance,2015,36799983,524079119,487279136
4,The Big Short,130,Comedy|Drama,2015,25759988,122678731,96918743
4,Mission: Impossible - Rogue Nation,131,Action,2015,137999939,627743451,489743512
4,Ted 2,115,Comedy,2015,62559972,198594430,136034458
4,Kingsman: The Secret Service,130,Crime|Comedy|Action|Adventure,2015,74519967,371497801,296977834
4,Spotlight,128,Drama|Thriller|History,2015,18399991,81278719,62878728
3,Maze Runner: The Scorch Trials,132,Action|Science Fiction|Thriller,2015,56119975,286356245,230236270
3,Chappie,120,Crime|Action|Science Fiction,2015,45079980,93903685,48823705
3,Pitch Perfect 2,115,Comedy|Music,2015,26679988,264505582,237825594
3,Bridge of Spies,141,Thriller|Drama,2015,36799983,149601569,112801586
3,Goosebumps,103,Adventure|Horror|Comedy,2015,53359976,138157089,84797113
3,Room,117,Drama|Thriller,2015,5519997,32569603,27049606
3,The Good Dinosaur,93,Adventure|Animation|Comedy|Family|Fantasy,2015,160999929,305371920,144371991
3,Run All Night,114,Action|Crime|Drama|Mystery|Thriller,2015,45999979,65836683,19836704
3,Brooklyn,111,Drama|Romance,2015,10119995,57110024,46990029
3,Straight Outta Compton,147,Drama|Music,2015,25759988,185504110,159744122
3,The Last Witch Hunter,106,Fantasy|Action|Adventure,2015,82799963,129164861,46364898
3,Steve Jobs,122,History|Drama,2015,27599987,31686509,4086522
3,The Man from U.N.C.L.E.,116,Comedy|Action|Adventure,2015,68999969,99493456,30493487
3,The Age of Adaline,112,Fantasy|Drama|Romance,2015,22999989,39219376,16219387
3,Hardcore Henry,97,Action|Adventure|Science Fiction,2015,9199995,13187081,3987086
2,Home,94,Fantasy|Comedy|Animation|Science Fiction|Family,2015,124199945,339361177,215161232
2,Paper Towns,109,Drama|Mystery|Romance,2015,11039995,78671281,67631286
2,The Lobster,118,Thriller|Comedy|Drama|Romance|Science Fiction,2015,3679998,8339346,4659348
2,Carol,118,Romance|Drama,2015,10855995,37050347,26194352
2,The Intern,121,Comedy,2015,32199985,178999419,146799434
2,Everest,121,Adventure|Drama,2015,50599977,187153294,136553317
2,Joy,124,Comedy|Drama,2015,55199975,93043293,37843318
2,Point Break,114,Action|Crime|Thriller,2015,96599957,123021160,26421203
2,Burnt,100,Drama,2015,18399991,33678188,15278197
2,Self/less,116,Science Fiction|Mystery|Thriller,2015,23919989,28081355,4161366
2,Mortdecai,106,Comedy|Adventure,2015,55199975,27985062,-27214913
2,The Danish Girl,120,Drama,2015,13799993,59056175,45256182
2,Blackhat,133,Mystery|Crime|Action|Thriller|Drama,2015,64399971,16332697,-48067274
2,Sicario,121,Action|Crime|Drama|Mystery|Thriller,2015,27599987,77303716,49703729
2,Fantastic Four,100,Action|Adventure|Science Fiction,2015,110399952,154539320,44139368
2,The Witch,92,Mystery|Horror,2015,3219998,37190013,33970015
2,Spy,120,Action|Comedy|Crime,2015,59799973,216812826,157012853
2,Focus,105,Romance|Comedy|Crime|Drama,2015,46091979,141645863,95553884
2,Hitman: Agent 47,96,Action|Crime|Thriller,2015,32199985,75759810,43559825
2,In the Heart of the Sea,122,Thriller|Drama|Adventure|Action|History,2015,91999959,86315059,-5684900
2,Creed,133,Drama,2015,32199985,126900665,94700680
2,Trainwreck,125,Comedy,2015,32199985,129532072,97332087
2,Eye in the Sky,102,Drama|Thriller|War,2015,11959994,30220316,18260322
2,Legend,131,Crime|Thriller,2015,22999989,39535137,16535148
2,Pan,111,Adventure|Family|Fantasy,2015,137999939,118117202,-19882737
2,The Peanuts Movie,88,Adventure|Animation|Comedy|Family,2015,91079959,226534364,135454405
2,Concussion,123,Drama,2015,32199985,44733666,12533681
2,The Night Before,100,Comedy,2015,22999989,48204295,25204306
2,Knock Knock,99,Drama|Horror|Thriller,2015,2299998,4796917,2496919
2,The Longest Ride,128,Romance|Drama,2015,31279986,57972193,26692207
2,Hotel Transylvania 2,89,Animation|Comedy|Family,2015,73599967,428888671,355288704
2,Love the Coopers,107,Family|Comedy,2015,15639993,22079990,6439997
2,The Walk,123,Adventure|Drama|Thriller,2015,32199985,56287361,24087376
2,Tracers,94,Action|Crime|Drama,2015,10119995,1714249,-8405746
2,Vacation,99,Adventure|Comedy,2015,28519987,96033410,67513423
1,Poltergeist,93,Horror|Thriller,2015,32199985,87802915,55602930
1,Maggie,95,Horror,2015,3679998,172142,-3507856
1,Child 44,137,Crime|Thriller,2015,45999979,3058382,-42941597
1,The Gift,108,Thriller|Mystery,2015,4599997,54260336,49660339
1,Daddy's Home,96,Comedy,2015,45999979,221131463,175131484
1,The Little Prince,92,Adventure|Animation|Fantasy,2015,58879974,89765510,30885536
1,The Dressmaker,118,Drama,2015,10975595,16872792,5897197
1,The DUFF,100,Romance|Comedy,2015,7819996,40046325,32226329
1,Sinister 2,97,Horror,2015,9199995,48651435,39451440
1,Paul Blart: Mall Cop 2,94,Action|Adventure|Comedy|Family,2015,27599987,98989419,71389432
1,The Boy Next Door,91,Thriller,2015,3679998,46150034,42470036
1,Entourage,104,Comedy,2015,27599987,45322311,17722324
1,The Wedding Ringer,101,Comedy,2015,21159990,73415857,52255867
1,Scouts Guide to the Zombie Apocalypse,93,Comedy|Horror,2015,13799993,13671898,-128095
1,The Visit,94,Horror|Thriller,2015,4599997,90574017,85974020
1,Black Mass,122,Crime|Drama,2015,48759978,91793583,43033605
1,Heist,93,Crime|Action|Thriller,2015,8187996,46125,-8141871
1,Krampus,98,Horror|Comedy|Fantasy,2015,13799993,56624785,42824792
1,Dark Places,113,Drama|Mystery|Thriller,2015,18399991,191900,-18208091
1,No Escape,103,Action|Thriller,2015,4599997,50065340,45465343
1,Dope,103,Crime|Drama|Comedy,2015,643999,16547831,15903832
1,American Ultra,96,Comedy|Action,2015,25759988,25951426,191438
1,Woman in Gold,120,Drama,2015,10119995,56690166,46570171
1,Sisters,118,Comedy,2015,27599987,96610126,69010139
1,Project Almanac,106,Science Fiction|Thriller,2015,11039995,29668368,18628373
1,The Transporter Refueled,96,Thriller|Action|Crime,2015,22999989,66819267,43819278
1,Crimson Peak,119,Mystery|Thriller|Fantasy|Horror|Drama,2015,50599977,68705406,18105429
1,Magic Mike XXL,115,Comedy|Drama|Music,2015,13615994,112619962,99003968
1,Paranormal Activity: The Ghost Dimension,88,Horror|Thriller,2015,9199995,71851557,62651562
1,Trumbo,124,Drama,2015,13799993,7576804,-6223189
1,Secret in Their Eyes,111,Crime|Drama|Mystery,2015,17939992,29614535,11674543
1,The SpongeBob Movie: Sponge Out of Water,93,Family|Animation,2015,68079970,286666383,218586413
1,Max,111,Adventure|Drama|Family,2015,18399991,40449856,22049865
1,The Gunman,115,Action|Drama|Crime,2015,36799983,9811564,-26988419
1,Unfriended,82,Horror|Thriller,2015,919999,57851497,56931498
1,Hot Pursuit,87,Action|Crime|Comedy,2015,32199985,47545764,15345779
1,Insidious: Chapter 3,97,Drama|Horror|Thriller,2015,9199995,95959500,86759505
1,The Lady in the Van,104,Comedy|Drama,2015,5519997,38076655,32556658
1,Victor Frankenstein,109,Drama|Science Fiction|Thriller,2015,36799983,31489100,-5310883
1,Anomalisa,90,Animation|Comedy|Drama|Romance,2015,7359996,3458541,-3901455
1,The Diary of a Teenage Girl,102,Drama|Romance,2015,1839999,1358841,-481158
1,Irrational Man,95,Mystery|Drama,2015,10119995,25199786,15079791
0,Ricki and the Flash,100,Comedy|Drama|Music,2015,16559992,38019285,21459293
0,The Perfect Guy,100,Drama|Thriller,2015,11039995,55451294,44411299
0,While We're Young,97,Drama|Comedy,2015,9199995,6980483,-2219512
0,Get Hard,100,Comedy,2015,36799983,97990493,61190510
0,The 33,120,History|Drama,2015,22999989,22910495,-89494
0,Suffragette,106,Drama|History,2015,12879994,14722219,1842225
0,We Are Your Friends,96,Drama|Music|Romance,2015,5519997,10232318,4712321
0,The Second Best Exotic Marigold Hotel,122,Drama|Comedy,2015,9199995,79099969,69899974
0,Little Boy,106,Comedy|Drama|War,2015,18399991,5906690,-12493301
0,Aloha,105,Adventure|Comedy|Romance,2015,34039985,24150007,-9889978
0,Our Brand Is Crisis,108,Drama|Comedy,2015,25759988,6442077,-19317911
0,Freeheld,103,Romance|Drama,2015,6439997,527467,-5912530
0,Love,134,Drama|Romance,2015,2759998,639647,-2120351
0,Truth,121,Drama,2015,8831996,2338228,-6493768
0,Danny Collins,107,Comedy|Drama|Music,2015,9199995,9968887,768892
0,Rock the Kasbah,100,Comedy|Music|War,2015,13799993,2779009,-11020984
0,"Hello, My Name Is Doris",95,Comedy|Drama|Romance,2015,919999,13289393,12369394
0,The Vatican Tapes,91,Thriller|Horror,2015,11959994,1641981,-10318013
0,99 Homes,112,Drama,2015,7359996,1298972,-6061024
0,Hot Tub Time Machine 2,93,Comedy,2015,12879994,11329473,-1550521
0,Manglehorn,97,Drama,2015,3679998,131652,-3548346
0,A Walk in the Woods,104,Drama|Adventure|Comedy,2015,7359996,33111785,25751789
0,The Lazarus Effect,83,Thriller|Horror,2015,3035998,58981843,55945845
0,Unfinished Business,90,Comedy,2015,32199985,13276746,-18923239
0,Lost River,95,Fantasy|Thriller,2015,1839999,41796,-1798203
0,The Gallows,87,Horror|Thriller,2015,91999,39251239,39159240
0,By the Sea,122,Drama|Romance,2015,9199995,3068131,-6131864
0,Black or White,121,Drama,2015,8279996,19845485,11565489
0,I Saw the Light,123,Drama|Music,2015,11959994,1515044,-10444950
0,Jem and the Holograms,119,Drama|Music|Adventure|Fantasy,2015,4599997,2146988,-2453009
0,Beasts of No Nation,137,Drama|War,2015,5519997,83514,-5436483
0,Demonic,83,Thriller|Horror,2015,2759998,3116038,356040
0,The D Train,101,Drama|Comedy,2015,411721,709611,297890
0,Strangerland,111,Drama|Thriller,2015,9199995,16074,-9183921
0,Captive,97,Crime|Drama|Thriller,2015,1839999,2577386,737387
0,90 Minutes in Heaven,121,Drama,2015,4599997,4455281,-144716
0,Grandma,78,Drama|Comedy,2015,551999,6520452,5968453
0,War Room,120,Drama,2015,2759998,62366880,59606882
0,Stonewall,129,Drama,2015,12419994,172660,-12247334
24,Interstellar,169,Adventure|Drama|Science Fiction,2014,151980023,572690645,420710622
14,Guardians of the Galaxy,121,Action|Science Fiction|Adventure,2014,156585478,712291130,555705652
12,Captain America: The Winter Soldier,136,Action|Adventure|Science Fiction,2014,156585478,658365092,501779614
11,John Wick,101,Action|Thriller,2014,18421821,72526614,54104793
10,The Hunger Games: Mockingjay - Part 1,123,Science Fiction|Adventure|Thriller,2014,115136381,692752790,577616409
10,The Hobbit: The Battle of the Five Armies,144,Adventure|Fantasy,2014,230272762,879752289,649479527
8,Big Hero 6,102,Adventure|Family|Animation|Action|Comedy,2014,151980023,600648487,448668464
8,The Imitation Game,113,History|Drama|Thriller|War,2014,12895274,215126072,202230798
7,The Maze Runner,113,Action|Mystery|Science Fiction|Thriller,2014,31317095,320834306,289517211
6,Birdman,119,Drama|Comedy,2014,16579638,95070499,78490861
6,Gone Girl,145,Mystery|Thriller|Drama,2014,56186554,340186892,284000338
6,Fury,135,War|Drama|Action,2014,62634191,195103577,132469386
6,Night at the Museum: Secret of the Tomb,97,Adventure|Comedy|Fantasy|Family,2014,116978563,321851579,204873016
6,Divergent,139,Action|Science Fiction|Thriller,2014,78292739,265963102,187670363
6,X-Men: Days of Future Past,131,Action|Adventure|Fantasy|Science Fiction,2014,230272762,687133923,456861161
5,Lucy,89,Action|Science Fiction,2014,36843642,426796807,389953165
5,Teenage Mutant Ninja Turtles,101,Science Fiction|Action|Adventure|Fantasy|Comedy,2014,115136381,439544649,324408268
5,Sex Tape,97,Comedy,2014,36843642,116121496,79277854
5,Nightcrawler,117,Crime|Drama|Thriller,2014,7829273,35643660,27814387
4,Transformers: Age of Extinction,165,Science Fiction|Action|Adventure,2014,193429120,226127853,32698733
4,The Grand Budapest Hotel,99,Comedy|Drama,2014,27632731,160822790,133190059
4,Whiplash,105,Drama|Music,2014,3039600,12888912,9849312
4,Dawn of the Planet of the Apes,130,Science Fiction|Action|Drama|Thriller,2014,156585478,652316682,495731204
4,The Equalizer,132,Thriller|Action|Crime,2014,50660007,177154121,126494114
4,Horrible Bosses 2,108,Comedy,2014,38685824,98230083,59544259
4,The Amazing Spider-Man 2,142,Action|Adventure|Fantasy,2014,184218210,650030011,465811801
3,Edge of Tomorrow,113,Action|Science Fiction,2014,163954207,341302234,177348027
3,The Interview,112,Action|Comedy,2014,40528006,10413095,-30114911
3,American Sniper,134,War|Action,2014,54160153,499514514,445354361
3,Exodus: Gods and Kings,153,Adventure|Drama|Action,2014,128952747,246881718,117928971
3,Godzilla,123,Action|Science Fiction|Thriller,2014,147374568,487327232,339952664
3,Maleficent,97,Fantasy|Adventure|Action|Family|Romance,2014,165796389,698565012,532768623
3,The November Man,108,Crime|Action|Thriller,2014,13816365,29987149,16170784
3,Ouija,89,Horror,2014,4605455,94439261,89833806
3,How to Train Your Dragon 2,102,Fantasy|Action|Adventure|Animation|Comedy,2014,133558202,561057788,427499586
3,It Follows,100,Thriller|Horror,2014,1842182,12434729,10592547
3,The Expendables 3,127,Action|Adventure|Thriller,2014,82898194,189903685,107005491
3,The Lego Movie,100,Adventure|Fantasy|Animation|Comedy|Action,2014,55265463,432139714,376874251
3,Seventh Son,102,Adventure|Fantasy,2014,87503649,105168898,17665249
3,The Theory of Everything,123,Drama|Romance,2014,13816365,111638022,97821657
3,Let's Be Cops,104,Comedy,2014,15658547,125840630,110182083
3,Dracula Untold,92,Horror|Action|Drama|Fantasy|War,2014,64476373,198522018,134045645
3,Penguins of Madagascar,92,Family|Animation|Adventure|Comedy,2014,121584018,344075490,222491472
2,Into the Woods,125,Fantasy|Comedy|Music,2014,46054552,196102469,150047917
2,300: Rise of an Empire,102,Action|War,2014,101320015,310941963,209621948
2,The Giver,94,Drama|Science Fiction,2014,23027276,61695098,38667822
2,22 Jump Street,112,Crime|Comedy|Action,2014,46054552,173571884,127517332
2,A Walk Among the Tombstones,113,Crime|Drama|Mystery|Thriller,2014,25790549,48985095,23194546
2,Paddington,95,Comedy,2014,50660007,238753457,188093450
2,Cake,102,Drama,2014,6447637,2174033,-4273604
2,Chef,115,Comedy,2014,10132001,42340653,32208652
2,The Purge: Anarchy,104,Horror|Thriller,2014,8289819,100198906,91909087
2,Left Behind,110,Thriller|Action|Science Fiction,2014,14737456,18129765,3392309
2,Boyhood,164,Drama,2014,3684364,40849467,37165103
2,A Most Violent Year,125,Action|Thriller|Crime|Drama,2014,18421821,11059604,-7362217
2,Hercules,99,Action|Adventure,2014,92109105,224193561,132084456
2,Noah,139,Drama|Adventure,2014,115136381,334022131,218885750
2,The Judge,141,Drama,2014,46054552,77113179,31058627
2,Blended,117,Comedy,2014,36843642,113749780,76906138
2,Neighbors,96,Comedy,2014,16579638,246997381,230417743
2,If I Stay,106,Drama,2014,10132001,72650912,62518911
2,Step Up All In,112,Romance|Drama|Music,2014,41449097,79366405,37917308
2,The Fault in Our Stars,125,Romance|Drama,2014,11053092,281072099,270019007
2,Ride Along,99,Action|Comedy,2014,23027276,141846012,118818736
2,Inherent Vice,148,Comedy|Romance|Crime|Drama|Mystery,2014,18421821,10234219,-8187602
2,Jack Ryan: Shadow Recruit,105,Action|Drama|Thriller,2014,55265463,46560330,-8705133
2,Non-Stop,106,Action|Thriller|Mystery,2014,46054552,205227928,159173376
2,Predestination,97,Science Fiction|Thriller,2014,5066000,2763273,-2302727
1,The Drop,106,Drama|Crime,2014,11605747,17186067,5580320
1,RoboCop,102,Science Fiction|Action,2014,110530926,220490244,109959318
1,Transcendence,119,Thriller|Science Fiction|Drama|Mystery,2014,92109105,94908538,2799433
1,The Other Woman,109,Comedy|Romance,2014,36843642,181253395,144409753
1,Mr. Peabody & Sherman,92,Animation|Adventure|Family,2014,133558202,251377196,117818994
1,Sin City: A Dame to Kill For,102,Crime|Thriller,2014,59870918,36298002,-23572916
1,Rio 2,102,Animation|Adventure|Comedy|Family,2014,94872378,460719091,365846713
1,Dumb and Dumber To,110,Comedy,2014,36843642,156435350,119591708
1,The Monuments Men,118,War|Drama|History|Action,2014,64476373,142754407,78278034
1,Unbroken,137,Drama|War,2014,59870918,150545826,90674908
1,Selma,127,History|Drama,2014,18421821,61517744,43095923
1,Mommy,138,Drama,2014,4513346,3218356,-1294990
1,Wild,115,Drama,2014,13816365,48358699,34542334
1,Pompeii,105,Action|Adventure|History|Romance|Drama,2014,119741836,108533660,-11208176
1,The Best of Me,117,Drama|Romance,2014,23948367,33091313,9142946
1,Annie,119,Music|Comedy|Drama|Family,2014,59870918,123262077,63391159
1,The Book of Life,95,Romance|Animation|Adventure|Comedy|Family,2014,46054552,89748446,43693894
1,St. Vincent,102,Comedy,2014,11974183,50510085,38535902
1,Need for Speed,130,Action|Crime|Drama|Thriller,2014,60792009,187237211,126445202
1,The Hundred-Foot Journey,122,Drama,2014,20264003,81867328,61603325
1,The Boxtrolls,97,Animation|Comedy|Family|Fantasy,2014,55265463,99713420,44447957
1,Big Eyes,105,Drama,2014,9210910,26604343,17393433
1,The Prince,93,Thriller|Action,2014,16579638,245550715,228971077
1,The Signal,95,Thriller|Science Fiction,2014,3684364,553479,-3130885
1,Into the Storm,89,Action|Thriller,2014,46054552,147929243,101874691
1,Planes: Fire & Rescue,83,Animation|Comedy|Adventure|Family,2014,46054552,139237453,93182901
1,Sabotage,110,Action|Drama|Thriller|Crime,2014,32238186,16126939,-16111247
1,No Good Deed,84,Thriller,2014,12158401,49582713,37424312
1,Still Alice,99,Drama,2014,4605455,38499379,33893924
1,"As Above, So Below",93,Horror|Thriller,2014,4605455,36935751,32330296
1,Foxcatcher,134,Drama|Thriller,2014,22106185,11141793,-10964392
1,Endless Love,103,Drama|Romance,2014,18421821,31388867,12967046
1,The Rover,100,Crime|Drama,2014,11283365,2114293,-9169072
1,Think Like a Man Too,106,Comedy|Romance,2014,22106185,64643485,42537300
1,Suite FranÃ§aise,107,Drama|Romance|War,2014,13816365,8386272,-5430093
1,Walk of Shame,95,Comedy,2014,13816365,54536,-13761829
1,Annabelle,99,Horror,2014,5987091,235130424,229143333
0,"I, Frankenstein",92,Horror|Thriller,2014,59870918,65539857,5668939
0,That Awkward Moment,94,Comedy|Romance,2014,7368728,23993576,16624848
0,Draft Day,109,Drama,2014,24869458,26556109,1686651
0,Brick Mansions,90,Action|Crime|Drama,2014,25790549,63460252,37669703
0,The Babadook,93,Drama|Thriller|Horror,2014,1842182,6149637,4307455
0,Tammy,97,Comedy,2014,18421821,92593075,74171254
0,Winter's Tale,118,Drama|Fantasy|Mystery|Romance,2014,55265463,28369817,-26895646
0,The Guest,99,Mystery|Thriller|Action,2014,4605455,2180370,-2425085
0,The Water Diviner,112,War|Drama,2014,20724548,14295354,-6429194
0,The Green Inferno,100,Horror|Thriller,2014,4605455,6294225,1688770
0,"Alexander and the Terrible, Horrible, No Good, Very Bad Day",81,Family|Comedy,2014,25790549,92711635,66921086
0,This Is Where I Leave You,103,Drama|Comedy,2014,18237602,38037670,19800068
0,The Homesman,122,Western|Drama,2014,14737456,2238241,-12499215
0,Big Game,90,Action|Adventure,2014,7829273,6908182,-921091
0,Jersey Boys,134,Music|Drama,2014,36843642,62032730,25189088
0,About Last Night,100,Comedy|Romance,2014,11513638,45135933,33622295
0,Million Dollar Arm,124,Drama,2014,23027276,35284812,12257536
0,Wish I Was Here,120,Drama|Comedy,2014,5066000,5050617,-15383
0,Infinitely Polar Bear,87,Comedy|Drama,2014,6171310,1317763,-4853547
0,Under the Skin,108,Thriller|Science Fiction|Drama,2014,12250510,4955701,-7294809
0,Veronica Mars,107,Comedy|Drama|Crime,2014,5526546,3210119,-2316427
0,Son of God,138,Drama,2014,20264003,62450032,42186029
0,Barefoot,90,Comedy|Drama|Romance,2014,5526546,13881,-5512665
0,Justice League: War,79,Animation,2014,3223818,4748523,1524705
0,The Zero Theorem,107,Drama|Fantasy|Science Fiction,2014,7829273,709890,-7119383
0,When the Game Stands Tall,115,Drama,2014,13816365,27750597,13934232
0,Decoding Annie Parker,91,Drama,2014,1842182,44571,-1797611
0,The Quiet Ones,98,Horror,2014,184218,16427536,16243318
0,A Most Wanted Man,121,Thriller,2014,13816365,29064894,15248529
0,The Pyramid,89,Horror,2014,5987091,12771328,6784237
0,Clouds of Sils Maria,124,Drama,2014,6079200,1431375,-4647825
0,Kill the Messenger,112,Thriller|Crime|Drama|Mystery,2014,4605455,2257452,-2348003
0,Honeymoon,87,Horror,2014,921091,8582,-912509
0,Locke,85,Drama|Thriller,2014,1842182,4269533,2427351
0,Dolphin Tale 2,107,Family|Drama,2014,33159277,48287768,15128491
0,The Woman in Black 2: Angel of Death,90,Thriller|Horror|Drama,2014,921091,24410131,23489040
0,Muppets Most Wanted,112,Comedy|Adventure|Crime|Family,2014,46054552,74040166,27985614
0,Tusk,102,Comedy|Drama|Horror,2014,2579054,1682561,-896493
0,5 Flights Up,92,Drama,2014,5526546,940361,-4586185
0,Heaven is for Real,99,Drama,2014,11053092,93336884,82283792
0,The Legend of Hercules,99,Action|Adventure,2014,64476373,56443954,-8032419
0,And So It Goes,94,Comedy|Drama|Romance,2014,27632731,23315013,-4317718
0,Life After Beth,90,Romance|Comedy|Horror,2014,2210618,81307,-2129311
0,Miss Julie,120,Drama,2014,5066000,4605455,-460545
0,Song One,86,Drama,2014,5526546,29706,-5496840
0,A Girl Walks Home Alone at Night,99,Horror|Romance,2014,921091,363830,-557261
0,Afflicted,85,Horror|Thriller,2014,292906,111616,-181290
0,Beyond the Lights,116,Drama,2014,6447637,13465178,7017541
0,Moms' Night Out,98,Comedy,2014,4605455,9606709,5001254
0,Earth to Echo,89,Family|Adventure|Science Fiction,2014,11974183,41725424,29751241
0,The Gambler,111,Thriller|Crime|Drama,2014,23027276,36080177,13052901
0,The Grand Seduction,112,Comedy,2014,11697856,3159358,-8538498
0,Joe,118,Drama,2014,3684364,2178810,-1505554
0,Parts Per Billion,139,Science Fiction,2014,460545,13816365,13355820
0,Better Living Through Chemistry,91,Drama|Comedy,2014,4605455,69213,-4536242
0,God's Not Dead,113,Drama,2014,15658547,27438381,11779834
0,Devil's Due,89,Horror,2014,6447637,33559008,27111371
0,My Old Lady,107,Romance|Comedy|Drama,2014,4605455,3697062,-908393
0,Aloft,112,Drama,2014,7368728,48897,-7319831
0,Mrs. Brown's Boys D'Movie,94,Comedy,2014,5434437,21185094,15750657
12,Star Wars,121,Adventure|Action|Science Fiction,1977,39575591,2789712242,2750136651
2,The Spy Who Loved Me,125,Adventure|Action|Thriller,1977,50368934,667167740,616798806
1,The Rescuers,78,Fantasy|Family|Animation|Adventure,1977,4317337,256219102,251901765
1,Annie Hall,93,Comedy|Drama|Romance,1977,14391124,137620251,123229127
1,Close Encounters of the Third Kind,135,Science Fiction|Drama,1977,71955620,1092964989,1021009369
1,A Bridge Too Far,175,Drama|History|War,1977,79151182,182587387,103436205
0,Sinbad and the Eye of the Tiger,113,Action|Adventure|Family|Fantasy|Science Fiction,1977,12592233,57564496,44972263
0,Saturday Night Fever,118,Drama|Music,1977,12592233,853081316,840489083
0,High Anxiety,94,Comedy|Music,1977,12232455,111758008,99525553
0,The Gauntlet,109,Drama|Action|Crime|Thriller,1977,19787795,95034155,75246360
0,Exorcist II: The Heretic,118,Horror|Thriller|Fantasy,1977,50368934,110628679,60259745
0,Airport '77,114,Action|Adventure|Drama|Thriller,1977,21586686,107933431,86346745
0,Eraserhead,89,Science Fiction|Fantasy|Horror|Drama,1977,35977,25184467,25148490
0,Orca: The Killer Whale,92,Drama|Adventure|Horror,1977,21586686,52951615,31364929
0,Sorcerer,121,Action|Thriller|Adventure,1977,79151182,43173372,-35977810
0,The Last Wave,106,Drama|Thriller|Mystery,1977,2914202,4526008,1611806
0,Kingdom of the Spiders,97,Horror|Science Fiction,1977,1798890,61162277,59363387
0,Wizards,80,Animation|Fantasy|Science Fiction,1977,4317337,32380029,28062692
0,The Hills Have Eyes,89,Horror,1977,827489,89944525,89117036
9,Avatar,162,Action|Adventure|Fantasy|Science Fiction,2009,240886902,2827123750,2586236848
6,Inglourious Basterds,153,Drama|Action|Thriller|War,2009,71148030,324364937,253216907
5,Underworld: Rise of the Lycans,92,Fantasy|Action|Adventure|Science Fiction|Thriller,2009,35574015,92825002,57250987
5,Harry Potter and the Half-Blood Prince,153,Adventure|Fantasy|Family,2009,254100108,949276533,695176425
4,Up,96,Animation|Comedy|Family|Adventure,2009,177870076,743337082,565467006
3,Star Trek,127,Science Fiction|Action|Adventure,2009,152460065,392005772,239545707
3,Terminator Salvation,115,Drama|Action|Thriller|Science Fiction,2009,203280086,377443351,174163265
3,District 9,112,Action|Thriller|Science Fiction,2009,30492013,214277144,183785131
3,Sherlock Holmes,128,Adventure|Drama|Action|Comedy|Thriller,2009,91476039,532622976,441146937
3,(500) Days of Summer,95,Comedy|Drama|Romance,2009,7623003,61718613,54095610
3,Ice Age: Dawn of the Dinosaurs,94,Animation|Comedy|Family|Adventure,2009,91476039,901228865,809752826
3,The Hangover,100,Comedy,2009,35574015,466802856,431228841
3,Watchmen,162,Action|Mystery|Science Fiction,2009,132132056,188297310,56165254
2,2012,158,Action|Adventure|Science Fiction,2009,203280086,782276248,578996162
2,9,79,Action|Adventure|Animation|Science Fiction|Thriller,2009,30492013,49222304,18730291
2,Angels & Demons,138,Thriller|Mystery,2009,152460065,362462054,210001989
2,The Princess and the Frog,97,Romance|Family|Animation|Music,2009,106722045,271425431,164703386
2,The Blind Side,129,Drama,2009,29475612,314279459,284803847
2,Zombieland,88,Comedy|Horror,2009,23987050,104070645,80083595
1,The Twilight Saga: New Moon,130,Adventure|Fantasy|Drama|Romance,2009,50820021,721468940,670648919
1,He's Just Not That Into You,129,Comedy|Romance|Drama,2009,40656017,180166572,139510555
1,G.I. Joe: The Rise of Cobra,118,Adventure|Action|Thriller|Science Fiction,2009,177870076,307429640,129559564
1,The Proposal,108,Comedy|Romance|Drama,2009,40656017,322580119,281924102
1,The Ugly Truth,96,Comedy|Romance,2009,38623216,208665898,170042682
1,Cloudy with a Chance of Meatballs,90,Animation|Comedy|Family,2009,101640043,246973582,145333539
1,Fantastic Mr. Fox,87,Adventure|Animation|Comedy|Family,2009,40656017,47233167,6577150
1,Coraline,100,Animation|Family,2009,60984026,126639833,65655807
1,Night at the Museum: Battle of the Smithsonian,105,Adventure|Fantasy|Action|Comedy|Family,2009,152460065,419881290,267421225
1,17 Again,102,Comedy,2009,20328008,138502321,118174313
1,A Christmas Carol,96,Animation|Drama,2009,203280086,330567839,127287753
1,The Lovely Bones,136,Fantasy|Drama,2009,66066028,95059446,28993418
1,Paul Blart: Mall Cop,91,Action|Adventure|Comedy|Family,2009,26426411,186299217,159872806
1,Hachi: A Dog's Tale,93,Drama|Family,2009,16262406,48585352,32322946
1,Law Abiding Citizen,109,Drama|Crime|Thriller,2009,53869223,128768508,74899285
1,The Box,115,Thriller|Science Fiction,2009,30492013,33880215,3388202
1,Crank: High Voltage,96,Action|Thriller|Crime,2009,20328008,35127385,14799377
1,Pandorum,108,Action|Horror|Mystery|Science Fiction|Thriller,2009,33541214,20983919,-12557295
1,Drag Me to Hell,99,Horror|Thriller,2009,30492013,92332504,61840491
1,Knowing,121,Action|Adventure|Drama|Mystery|Science Fiction,2009,50820021,157995749,107175728
1,Moon,97,Science Fiction|Drama,2009,5082002,9920173,4838171
1,G-Force,88,Fantasy|Action|Adventure|Family|Comedy,2009,152460065,297620180,145160115
1,The Taking of Pelham 1 2 3,106,Thriller|Drama|Crime,2009,101640043,152628915,50988872
1,The Invention of Lying,100,Comedy|Romance|Fantasy,2009,18803408,32436176,13632768
1,Confessions of a Shopaholic,104,Comedy|Romance,2009,40656017,110109447,69453430
1,Gamer,95,Action|Thriller|Science Fiction,2009,50820021,41498145,-9321876
1,Mr. Nobody,141,Science Fiction|Drama|Romance|Fantasy,2009,47770820,3605384,-44165436
1,Couples Retreat,113,Comedy|Romance,2009,71148030,174663170,103515140
1,Brothers,104,Drama|Thriller|War,2009,26426411,44028788,17602377
1,The Road,111,Adventure|Drama,2009,32524813,28088536,-4436277
1,Monsters vs Aliens,94,Animation|Family|Adventure|Science Fiction,2009,177870076,387766797,209896721
1,Fish Tank,123,Drama,2009,3049201,2396521,-652680
1,Julie & Julia,123,Romance|Drama,2009,40656017,131665019,91009002
1,Chloe,96,Drama|Thriller|Mystery,2009,15246006,8598196,-6647810
1,Public Enemies,140,History|Crime|Drama,2009,81312034,217616028,136303994
1,Jennifer's Body,100,Comedy|Horror,2009,16262406,32073594,15811188
1,Orphan,123,Horror|Thriller|Mystery,2009,20328008,42278447,21950439
1,All About Steve,99,Comedy,2009,15246006,40763290,25517284
1,The Final Destination,82,Horror|Mystery,2009,40656017,189220360,148564343
1,Alvin and the Chipmunks: The Squeakquel,88,Comedy|Family|Animation|Fantasy|Music,2009,76230032,450407693,374177661
1,After.Life,104,Drama|Horror|Mystery|Thriller,2009,4573801,3665541,-908260
1,Bride Wars,89,Comedy,2009,30492013,116543991,86051978
1,Precious,110,Drama,2009,10164004,64691685,54527681
1,State of Play,127,Action,2009,60984026,89223892,28239866
1,The Unborn,87,Horror|Thriller|Mystery,2009,16262406,77768913,61506507
1,"New York, I Love You",103,Drama|Comedy|Romance,2009,14941086,8181684,-6759402
1,"I Love You, Man",105,Comedy,2009,41672417,93139872,51467455
1,The Informant!,108,Comedy|Crime|Drama|Thriller,2009,22360809,36005808,13644999
1,Race to Witch Mountain,98,Adventure|Family|Fantasy|Science Fiction|Thriller,2009,50820021,108047419,57227398
0,Case 39,109,Horror|Mystery|Thriller,2009,27442811,29475612,2032801
0,The Boat That Rocked,116,Drama|Comedy,2009,50820021,36944919,-13875102
0,Daybreakers,98,Fantasy|Horror|Action|Thriller|Science Fiction,2009,20328008,52259716,31931708
0,The Time Traveler's Wife,107,Drama|Romance|Fantasy,2009,39639616,102890004,63250388
0,Antichrist,108,Drama|Horror|Thriller,2009,11180404,804853,-10375551
0,Love Happens,109,Drama|Romance,2009,18295207,36725611,18430404
0,Push,111,Action,2009,38623216,46210949,7587733
0,Brooklyn's Finest,133,Crime|Drama|Thriller,2009,17278807,30020707,12741900
0,Saw VI,90,Horror|Mystery,2009,11180404,69352690,58172286
0,The Young Victoria,105,Drama|History|Romance,2009,35574015,27859423,-7714592
0,A Serious Man,105,Comedy|Drama,2009,7114803,31945805,24831002
0,A Perfect Getaway,98,Thriller|Mystery|Adventure,2009,14229606,23227431,8997825
0,Whiteout,101,Action|Crime|Mystery|Thriller,2009,40656017,12406212,-28249805
0,I Love You Phillip Morris,98,Comedy|Drama|Romance,2009,13213205,10826733,-2386472
0,Enter the Void,161,Fantasy|Drama,2009,13213205,766619,-12446586
0,12 Rounds,108,Action|Adventure|Drama|Thriller,2009,20328008,17563730,-2764278
0,3 Idiots,170,Drama|Comedy|Romance,2009,9147603,71148030,62000427
0,Transformers: Revenge of the Fallen,150,Science Fiction|Action|Adventure,2009,152460065,850012865,697552800
0,The Men Who Stare at Goats,93,Comedy|War,2009,24393610,69856549,45462939
0,Ninja Assassin,99,Action|Crime|Thriller,2009,40656017,61453955,20797938
0,Bandslam,111,Comedy|Drama|Family|Music,2009,20328008,5296450,-15031558
0,Where the Wild Things Are,101,Family|Fantasy,2009,101640043,101728259,88216
0,It's Complicated,121,Comedy|Romance,2009,86394036,222697050,136303014
0,Land of the Lost,102,Adventure|Comedy|Science Fiction,2009,101640043,69815357,-31824686
0,Invictus,134,Drama|History,2009,60984026,124238661,63254635
0,Planet 51,91,Science Fiction|Animation|Family|Comedy|Adventure,2009,71148030,106666921,35518891
0,Year One,97,Comedy|Adventure,2009,60984026,63380596,2396570
0,Life During Wartime,97,Comedy|Drama,2009,4573801,757031,-3816770
0,Ondine,111,Drama|Romance,2009,12196805,1671729,-10525076
0,My Bloody Valentine,101,Mystery|Horror,2009,15246006,102386811,87140805
0,Old Dogs,88,Comedy|Family,2009,35574015,93731746,58157731
0,Agora,127,Adventure|Drama|History,2009,71148030,39681802,-31466228
0,The Boondock Saints II: All Saints Day,118,Action|Thriller|Crime,2009,8131203,10803646,2672443
0,The Bad Lieutenant: Port of Call - New Orleans,122,Drama|Crime,2009,25410010,10762767,-14647243
0,The Imaginarium of Doctor Parnassus,123,Adventure|Fantasy|Mystery,2009,30492013,62822465,32330452
0,Horsemen,90,Crime|Drama|Horror|Mystery|Thriller,2009,20328008,1034086,-19293922
0,Armored,88,Action|Crime|Drama|Thriller,2009,20328008,23318483,2990475
0,Cirque du Freak: The Vampire's Assistant,109,Adventure|Fantasy|Action|Thriller,2009,40656017,28631665,-12024352
0,Leaves of Grass,104,Comedy|Crime|Drama|Thriller,2009,9147603,1001273,-8146330
0,An Education,100,Drama|Romance,2009,7623003,26524851,18901848
0,Funny People,146,Comedy|Drama,2009,76230032,62466935,-13763097
0,Up in the Air,109,Drama|Romance,2009,25410010,166354259,140944249
0,Astro Boy,94,Animation|Action|Family|Science Fiction,2009,66066028,44814179,-21251849
0,The International,118,Drama|Thriller|Crime,2009,50820021,61148063,10328042
0,Universal Soldier: Regeneration,97,Adventure|Action|Science Fiction|Thriller,2009,14229606,889742,-13339864
0,Fast & Furious,107,Action|Crime|Drama|Thriller,2009,86394036,369120316,282726280
0,Capitalism: A Love Story,120,Documentary,2009,20328008,17722475,-2605533
0,Halloween II,105,Horror,2009,15246006,40067996,24821990
0,Hannah Montana: The Movie,102,Comedy|Drama|Family|Music|Romance,2009,35574015,158096289,122522274
0,Banlieue 13 - Ultimatum,101,Action|Thriller|Crime,2009,15246006,8930475,-6315531
0,Aliens in the Attic,86,Adventure|Comedy|Family|Fantasy|Science Fiction,2009,45738019,58830330,13092311
0,The Collector,88,Horror|Thriller,2009,3455761,9598903,6143142
0,Women in Trouble,92,Comedy|Drama,2009,3049201,18393,-3030808
0,The Fourth Kind,98,Science Fiction|Thriller,2009,10164004,43027579,32863575
0,Solitary Man,90,Comedy|Drama|Romance,2009,15246006,5107190,-10138816
0,The Disappearance of Alice Creed,100,Crime|Drama|Thriller,2009,813120,881944,68824
0,Duplicity,125,Thriller,2009,79428291,60984026,-18444265
0,Bright Star,119,Drama|Romance,2009,8639403,4512873,-4126530
0,Adventureland,107,Comedy,2009,9655804,17445880,7790076
0,Extract,92,Comedy,2009,8131203,11026707,2895504
0,Defendor,101,Drama|Action|Comedy|Crime,2009,3557401,45191,-3512210
0,Nine,112,Drama|Music|Romance,2009,81312034,54708276,-26603758
0,The Messenger,113,Drama|History,2009,6606602,1546210,-5060392
0,Away We Go,98,Drama|Comedy|Romance,2009,17278807,15143773,-2135034
0,My Life in Ruins,95,Comedy|Romance,2009,17278807,20790751,3511944
0,My Sister's Keeper,109,Drama,2009,30492013,97284640,66792627
0,The Soloist,109,Drama,2009,60984026,32240382,-28743644
0,Friday the 13th,97,Horror,2009,19311608,92877707,73566099
0,Crossing Over,113,Drama,2009,25410010,1054347,-24355663
0,Harry Brown,103,Thriller|Crime|Drama|Action,2009,7419723,10499159,3079436
0,Surrogates,89,Action|Science Fiction|Thriller,2009,81312034,124452919,43140885
0,Street Fighter: The Legend of Chun-Li,97,Action|Adventure|Science Fiction|Thriller,2009,50820021,12973539,-37846482
0,Hotel for Dogs,100,Comedy|Family,2009,35574015,74232256,38658241
0,Obsessed,108,Drama|Thriller,2009,20328008,75041189,54713181
0,Tetro,127,Drama|Mystery,2009,15246006,115077,-15130929
0,Whip It,111,Drama,2009,15246006,16905823,1659817
0,Solomon Kane,104,Adventure|Fantasy|Action|Science Fiction,2009,45738019,7938087,-37799932
0,Survival of the Dead,90,Horror|Science Fiction,2009,4065601,145539,-3920062
0,X-Men Origins: Wolverine,107,Adventure|Action|Thriller|Science Fiction,2009,152460065,346726502,194266437
0,S. Darko,103,Thriller|Crime|Science Fiction|Mystery,2009,4065601,4167241,101640
0,Black Dynamite,90,Action|Comedy,2009,2947561,301420,-2646141
0,City Island,104,Drama|Comedy,2009,6098402,6780114,681712
0,Amelia,111,Drama|Adventure|Romance,2009,40656017,19574367,-21081650
0,Beyond a Reasonable Doubt,105,Drama,2009,25410010,4460537,-20949473
0,New in Town,97,Comedy|Romance,2009,8131203,29486606,21355403
0,Me and Orson Welles,114,Comedy|Drama|Romance,2009,25410010,2374486,-23035524
0,Shorts,89,Comedy|Family,2009,40656017,29447669,-11208348
0,Sorority Row,101,Horror|Mystery|Thriller,2009,12705005,27652312,14947307
0,ChÃ©ri,86,Drama|Comedy|Romance,2009,23377209,9519837,-13857372
0,The Joneses,96,Comedy|Drama,2009,10164004,7137903,-3026101
0,Fired Up!,90,Comedy|Romance,2009,20328008,18904135,-1423873
0,Wanted,129,Action|Comedy|Crime|Thriller,2009,76,136,60
0,World's Greatest Dad,99,Comedy|Romance,2009,10164004,300600,-9863404
0,The Girlfriend Experience,77,Comedy|Drama,2009,1727880,1024493,-703387
0,Post Grad,89,Comedy,2009,15246006,6510293,-8735713
0,Paper Heart,88,Comedy|Drama|Romance,2009,1016400,1318241,301841
0,Crazy Heart,112,Drama|Music|Romance,2009,7114803,40109639,32994836
0,Stolen Lives,97,Crime|Drama|Mystery|Thriller,2009,2032800,7425,-2025375
0,Like Dandelion Dust,100,Drama|Family,2009,2541001,358596,-2182405
0,I Hope They Serve Beer in Hell,106,Comedy|Drama,2009,7114803,1452740,-5662063
0,Beautiful,97,Drama|Mystery|Thriller,2009,1524600,56918,-1467682
0,Did You Hear About The Morgans?,103,Comedy,2009,58951225,86678883,27727658
0,The Grudge 3,90,Horror|Thriller,2009,5082002,39243229,34161227
0,Big Fan,91,Comedy|Drama,2009,254100,236548,-17552
0,Mao's Last Dancer,117,Drama|Romance,2009,25410010,21059258,-4350752
0,Down Terrace,89,Drama|Action|Comedy,2009,31703,10164,-21539
9,Inception,148,Action|Thriller|Science Fiction|Mystery|Adventure,2010,160000000,825500000,665500000
5,Iron Man 2,124,Adventure|Action|Science Fiction,2010,200000000,623933331,423933331
5,Alice in Wonderland,108,Family|Fantasy|Adventure,2010,200000000,1025467110,825467110
5,Black Swan,108,Drama|Mystery|Thriller,2010,13000000,327803731,314803731
4,Harry Potter and the Deathly Hallows: Part 1,146,Adventure|Fantasy|Family,2010,250000000,954305868,704305868
3,Despicable Me,95,Action|Animation|Family,2010,69000000,543513985,474513985
3,The Expendables,103,Action|Thriller,2010,80000000,274470394,194470394
3,How to Train Your Dragon,98,Fantasy|Adventure|Animation|Family,2010,165000000,494878759,329878759
3,Shutter Island,138,Drama|Thriller|Mystery,2010,80000000,294804195,214804195
2,TRON: Legacy,125,Adventure|Action|Science Fiction,2010,170000000,400062763,230062763
2,Tangled,100,Animation|Family,2010,260000000,591794936,331794936
2,Toy Story 3,103,Animation|Family|Comedy,2010,200000000,1063171911,863171911
2,Salt,100,Action|Thriller|Crime|Mystery,2010,110000000,293329073,183329073
2,127 Hours,94,Adventure|Drama|Thriller,2010,18000000,35692920,17692920
2,Easy A,92,Comedy,2010,8000000,74952305,66952305
2,The Chronicles of Narnia: The Voyage of the Dawn Treader,113,Adventure|Family|Fantasy,2010,155000000,415686217,260686217
2,Kick-Ass,117,Action|Crime,2010,28000000,96188903,68188903
2,The Tourist,103,Action|Thriller|Romance,2010,100000000,278346189,178346189
2,Prince of Persia: The Sands of Time,116,Adventure|Fantasy|Action|Romance,2010,150000000,335154643,185154643
2,Robin Hood,140,Action,2010,200000000,310669540,110669540
2,True Grit,110,Drama|Adventure|Western,2010,38000000,252276927,214276927
2,Clash of the Titans,106,Adventure|Fantasy|Action,2010,125000000,232713139,107713139
2,The Sorcerer's Apprentice,109,Fantasy|Adventure|Action|Comedy|Drama,2010,150000000,215283742,65283742
1,The Social Network,120,Drama,2010,40000000,224920315,184920315
1,Scott Pilgrim vs. the World,112,Action|Adventure|Comedy,2010,60000000,47664559,-12335441
1,Little Fockers,98,Comedy|Romance,2010,100000000,310650585,210650585
1,Predators,107,Action|Science Fiction|Adventure|Thriller,2010,40000000,126248813,86248813
1,Percy Jackson & the Olympians: The Lightning Thief,118,Adventure|Fantasy|Family,2010,95000000,226497209,131497209
1,Unstoppable,98,Action|Thriller,2010,100000000,167805466,67805466
1,Shrek Forever After,93,Comedy|Adventure|Fantasy|Animation|Family,2010,165000000,752600867,587600867
1,Dear John,115,Drama|Romance|War,2010,25000000,114977104,89977104
1,The A-Team,117,Thriller|Action|Adventure|Comedy|Crime,2010,110000000,177238796,67238796
1,RED,111,Action|Adventure|Comedy|Crime|Thriller,2010,58000000,71664962,13664962
1,Machete,105,Action|Comedy|Thriller,2010,20000000,31327899,11327899
1,Grown Ups,102,Comedy,2010,80000000,271430189,191430189
1,The Book of Eli,118,Action|Thriller|Science Fiction,2010,80000000,157107755,77107755
1,Date Night,97,Comedy,2010,55000000,152263880,97263880
1,The Town,125,Crime|Drama|Thriller,2010,37000000,154026136,117026136
1,The Twilight Saga: Eclipse,124,Adventure|Fantasy|Drama|Romance,2010,68000000,698491347,630491347
1,Megamind,95,Animation|Action|Comedy|Family|Science Fiction,2010,130000000,321885765,191885765
1,The Last Airbender,103,Action|Adventure|Family|Fantasy,2010,150000000,318502923,168502923
1,The Other Guys,107,Action|Comedy|Crime,2010,100000000,170432927,70432927
1,Insidious,103,Horror|Thriller,2010,1500000,97009150,95509150
1,Step Up 3D,107,Drama|Romance,2010,30000000,159291809,129291809
1,The King's Speech,118,Drama|History,2010,15000000,414211549,399211549
1,Love & Other Drugs,112,Drama|Comedy|Romance,2010,30000000,102820008,72820008
1,The Way Back,133,Drama|Adventure|History,2010,30000000,20348249,-9651751
1,Repo Men,111,Action|Science Fiction|Thriller|Crime,2010,32000000,18409891,-13590109
1,Last Night,90,Drama|Romance,2010,7000000,7644937,644937
1,Knight and Day,109,Action|Comedy,2010,117000000,261930431,144930431
1,Eat Pray Love,133,Drama,2010,60000000,204594016,144594016
1,Blue Valentine,112,Drama|Romance,2010,1000000,12355734,11355734
1,The Bounty Hunter,110,Action,2010,40000000,136000000,96000000
1,Leap Year,100,Romance|Comedy,2010,19000000,29922472,10922472
1,Green Zone,115,Action|Adventure|Drama|Thriller,2010,100000000,94882889,-5117111
1,Gulliver's Travels,85,Comedy,2010,112000000,237382724,125382724
1,The Back-Up Plan,106,Comedy|Romance,2010,35000000,77477008,42477008
1,Charlie St. Cloud,99,Drama,2010,44000000,48190704,4190704
1,The Switch,101,Comedy|Romance|Drama,2010,19000000,49830607,30830607
1,The Runaways,106,Drama|Music,2010,10000000,2995811,-7004189
1,Valentine's Day,125,Comedy|Romance,2010,52000000,216485654,164485654
1,Don't Be Afraid of the Dark,99,Fantasy|Horror|Thriller,2010,25000000,36993168,11993168
1,Saw 3D,90,Horror|Crime,2010,20000000,136150434,116150434
1,The Karate Kid,140,Action|Adventure|Drama|Family,2010,40000000,357852395,317852395
1,Due Date,95,Comedy|Drama,2010,65000000,211780824,146780824
1,Wild Target,98,Action|Comedy,2010,8000000,3453043,-4546957
1,From Paris with Love,92,Action|Crime|Thriller,2010,52000000,52615806,615806
1,The Ghost Writer,128,Thriller|Mystery,2010,45000000,60222298,15222298
1,It's Kind of a Funny Story,101,Comedy|Drama,2010,8000000,6491240,-1508760
1,The Next Three Days,133,Romance|Drama|Thriller|Crime,2010,30000000,51148651,21148651
1,A Nightmare on Elm Street,95,Horror|Mystery|Thriller,2010,35000000,115664037,80664037
1,The Losers,97,Action|Adventure|Crime|Mystery|Thriller,2010,25000000,23580000,-1420000
1,The Fighter,116,Drama,2010,25000000,9190869,-15809131
1,Get Him to the Greek,109,Comedy,2010,40000000,90029656,50029656
1,Jonah Hex,80,Action|Western|Drama|Fantasy|Thriller,2010,47000000,10539000,-36461000
1,Vampires Suck,82,Horror|Comedy,2010,20000000,80547866,60547866
1,Inside Job,109,Documentary,2010,2000000,7871522,5871522
0,Killers,100,Action|Comedy|Thriller|Romance,2010,75000000,98159963,23159963
0,Legion,100,Horror,2010,26000000,67918658,41918658
0,Sex and the City 2,146,Comedy|Drama|Romance,2010,100000000,288347692,188347692
0,You Again,105,Comedy|Romance,2010,20000000,32005248,12005248
0,Nanny McPhee and the Big Bang,109,Fantasy|Comedy,2010,35000000,93246388,58246388
0,Hot Tub Time Machine,101,Science Fiction|Comedy|Adventure,2010,36000000,64572262,28572262
0,Let Me In,116,Drama|Horror|Mystery,2010,20000000,24145613,4145613
0,Flipped,90,Comedy|Drama|Romance,2010,14000000,1755212,-12244788
0,Legend of the Guardians: The Owls of Ga'Hoole,97,Animation|Adventure|Family|Fantasy,2010,80000000,140073390,60073390
0,Takers,107,Action|Crime|Drama|Thriller,2010,32000000,69055695,37055695
0,Burlesque,119,Drama|Romance,2010,55000000,89519773,34519773
0,The Company Men,104,Drama,2010,15000000,4882577,-10117423
0,Going the Distance,102,Comedy|Drama|Romance,2010,32000000,42045846,10045846
0,Faster,98,Crime|Drama|Action|Thriller,2010,24000000,23081726,-918274
0,Paranormal Activity 2,91,Horror|Thriller,2010,3000000,177512032,174512032
0,Never Let Me Go,104,Drama|Romance|Science Fiction,2010,15000000,9455232,-5544768
0,The American,104,Crime|Drama|Thriller,2010,20000000,65464324,45464324
0,Cop Out,107,Action|Comedy|Crime,2010,30000000,55583804,25583804
0,Monsters,94,Drama|Thriller|Science Fiction,2010,500000,4242978,3742978
0,Life as We Know It,115,Comedy|Romance|Drama,2010,38000000,105610124,67610124
0,Centurion,97,Drama|Action|Thriller,2010,12000000,6814789,-5185211
0,Beginners,105,Drama|Romance|Comedy,2010,3200000,5332926,2132926
0,Shelter,112,Horror|Mystery|Thriller,2010,22000000,851517,-21148483
0,Stone,105,Drama,2010,22000000,9479718,-12520282
0,Diary of a Wimpy Kid,94,Comedy|Family,2010,15000000,75700498,60700498
0,I Spit on Your Grave,108,Thriller|Crime|Horror,2010,2000000,572809,-1427191
0,Piranha 3D,88,Comedy|Horror,2010,24000000,83188165,59188165
0,Morning Glory,102,Comedy|Drama|Romance,2010,40000000,58785180,18785180
0,Conviction,107,Drama,2010,12500000,6732980,-5767020
0,The Nutcracker: The Untold Story,110,Fantasy|Action|Family,2010,90000000,16178959,-73821041
0,The Last Exorcism,87,Horror|Drama|Thriller,2010,1800000,67738090,65938090
0,Tooth Fairy,101,Comedy|Family|Fantasy,2010,48000000,112462508,64462508
0,Fair Game,108,Drama|Thriller,2010,22000000,24188922,2188922
0,The Ward,88,Horror|Thriller,2010,10000000,498974,-9501026
0,Buried,94,Drama|Thriller|Mystery,2010,1987650,19152480,17164830
0,Dinner for Schmucks,114,Comedy,2010,69000000,86387857,17387857
0,The Kids Are All Right,106,Comedy|Drama,2010,4000000,34705850,30705850
0,Skyline,100,Science Fiction,2010,10000000,66821036,56821036
0,The Debt,113,Drama|Thriller,2010,20000000,45636368,25636368
0,Winter's Bone,100,Drama,2010,2000000,13831503,11831503
0,Ca$h,108,Crime|Thriller|Comedy,2010,7000000,46488,-6953512
0,Cats & Dogs 2 : The Revenge of Kitty Galore,82,Comedy|Family,2010,85000000,112483764,27483764
0,MacGruber,90,Action|Adventure|Comedy,2010,10000000,6110000,-3890000
0,How Do You Know,121,Comedy|Drama|Romance,2010,120000000,48668907,-71331093
0,Rubber,85,Comedy|Drama|Fantasy|Horror|Mystery,2010,500000,98017,-401983
0,The Spy Next Door,94,Action|Comedy|Family,2010,28000000,45236543,17236543
0,She's Out of My League,104,Comedy|Romance,2010,20000000,49779728,29779728
0,Henry's Crime,108,Action|Comedy|Thriller,2010,12000000,204940,-11795060
0,London Boulevard,103,Drama|Crime,2010,25000000,4644108,-20355892
0,Hereafter,129,Drama|Fantasy,2010,50000000,105197635,55197635
0,My Soul to Take,107,Drama|Horror|Mystery|Thriller,2010,25000000,19829957,-5170043
0,TEKKEN,92,Crime|Drama|Action|Thriller|Science Fiction,2010,30000000,967000,-29033000
0,The Conspirator,122,Crime|Drama|History,2010,25000000,15478800,-9521200
0,Death at a Funeral,92,Comedy,2010,21000000,49050886,28050886
0,Hesher,106,Drama,2010,7000000,382946,-6617054
0,Animal Kingdom,113,Drama|Thriller|Crime,2010,5000000,1000000,-4000000
0,Marmaduke,87,Family|Comedy,2010,50000000,83761844,33761844
0,Wall Street: Money Never Sleeps,133,Drama|Crime,2010,70000000,134748021,64748021
0,Carlos,338,Crime|Drama|Thriller|History,2010,18000000,871279,-17128721
0,Another Year,129,Comedy|Drama,2010,8000000,18124262,10124262
0,Everything Must Go,97,Comedy|Drama|Romance,2010,5000000,2614773,-2385227
0,The Crazies,101,Mystery|Horror|Action,2010,20000000,54956140,34956140
0,Rabbit Hole,91,Drama,2010,5000000,5129058,129058
0,Alpha and Omega,88,Family|Animation,2010,20000000,39300000,19300000
0,Yogi Bear,80,Comedy|Family|Animation|Adventure,2010,80000000,201584141,121584141
0,StreetDance 3D,98,Drama,2010,5773100,18144030,12370930
0,Super,96,Comedy|Action|Drama,2010,2500000,324138,-2175862
0,The Tempest,110,Fantasy|Drama,2010,20000000,346594,-19653406
0,Country Strong,117,Drama|Romance,2010,15000000,20529194,5529194
0,"Tomorrow, When the War Began",103,Action|Adventure|Drama,2010,27000000,16504936,-10495064
0,Extraordinary Measures,105,Drama,2010,31000000,15134293,-15865707
0,Devil,80,Horror|Mystery|Thriller,2010,10000000,33583175,23583175
0,Our Family Wedding,103,Comedy,2010,14000000,21409028,7409028
0,Halo Legends,93,Action|Animation|Science Fiction,2010,100000,1000000,900000
0,Barney's Version,134,Comedy|Drama,2010,30000000,8454301,-21545699
0,Edge of Darkness,117,Crime|Drama|Mystery|Thriller,2010,80000000,74901339,-5098661
0,4.3.2.1,117,Action|Thriller|Crime|Romance,2010,4600000,1163967,-3436033
0,Dirty Girl,90,Drama|Comedy,2010,4000000,55125,-3944875
0,Catfish,87,Documentary,2010,30000,3045943,3015943
0,Furry Vengeance,92,Comedy,2010,35000000,39340177,4340177
0,Casino Jack,108,Crime|Comedy|Drama,2010,12500000,1083683,-11416317
0,Hatchet II,89,Horror|Comedy|Thriller,2010,2500000,52604,-2447396
0,Dylan Dog: Dead of Night,107,Action|Comedy|Horror|Mystery|Science Fiction,2010,20000000,4634062,-15365938
0,Howl,84,Drama,2010,30000,617000,587000
0,Freakonomics,93,Documentary,2010,3000000,103735,-2896265
0,The Perfect Game,118,Drama|Family,2010,12500000,3878993,-8621007
0,Stake Land,98,Drama|Horror|Action|Thriller|Science Fiction,2010,650000,33245,-616755
0,The Warrior's Way,100,Adventure|Fantasy|Action|Western|Thriller,2010,425000000,11087569,-413912431
0,Burke & Hare,91,Comedy|Thriller,2010,10000000,4349187,-5650813
0,Inhale,100,Drama|Action|Thriller,2010,10000000,55089,-9944911
0,Four Lions,101,Comedy|Crime|Drama,2010,967686,4270000,3302314
0,Waste Land,90,Documentary|Foreign,2010,1500000,187716,-1312284
0,The Extra Man,108,Comedy,2010,7000000,453079,-6546921
0,The Romantics,95,Comedy|Drama|Romance,2010,4500000,123820,-4376180
0,Balada triste de trompeta,101,Drama|Action|Thriller|Foreign,2010,7000000,3218666,-3781334
0,Why Did I Get Married Too?,121,Comedy|Romance,2010,20000000,60072596,40072596
0,Resident Evil: Afterlife,97,Action|Adventure|Horror|Science Fiction,2010,60000000,296221663,236221663
0,Vanishing on 7th Street,92,Drama|Horror|Thriller,2010,10000000,1068682,-8931318
0,Action Replayy,100,Drama|Comedy|Romance|Foreign,2010,10000000,5000000,-5000000
0,Secretariat,123,Drama,2010,35000000,60251371,25251371
0,Boy,87,Drama|Comedy,2010,3,43,40
8,Fight Club,139,Drama,1999,82470329,132022892,49552563
7,The Matrix,136,Action|Science Fiction,1999,82470329,606768749,524298420
3,American Beauty,122,Drama,1999,19635792,466411079,446775287
3,Star Wars: Episode I - The Phantom Menace,136,Adventure|Action|Science Fiction,1999,150541077,1209980530,1059439453
2,The Mummy,124,Adventure|Fantasy|Horror|Action|Thriller,1999,104724227,544416081,439691854
2,The Green Mile,189,Fantasy|Drama|Crime,1999,78543170,372556440,294013270
2,The Sixth Sense,107,Mystery|Thriller|Drama,1999,52362113,880738991,828376878
2,The World Is Not Enough,128,Adventure|Action|Thriller,1999,176722134,473657733,296935599
2,Cruel Intentions,97,Drama|Romance|Thriller,1999,13745054,99360001,85614947
2,Sleepy Hollow,105,Drama|Fantasy|Thriller|Mystery,1999,130905284,269758486,138853202
1,American Pie,95,Comedy|Romance,1999,14399581,308259696,293860115
1,Entrapment,112,Romance|Drama|Mystery,1999,86397487,278048579,191651092
1,Toy Story 2,92,Animation|Comedy|Family,1999,117814756,634910500,517095744
1,10 Things I Hate About You,97,Comedy|Romance|Drama,1999,20944845,70005745,49060900
1,Notting Hill,124,Comedy,1999,54980219,476350818,421370599
1,Austin Powers: The Spy Who Shagged Me,95,Crime|Adventure|Action|Comedy|Science Fiction,1999,43198743,407037004,363838261
1,Boys Don't Cry,118,Crime|Drama,1999,2618105,15107264,12489159
1,The Insider,157,Drama|Thriller,1999,117814756,78922680,-38892076
1,Galaxy Quest,102,Comedy|Family|Science Fiction,1999,58907378,118710038,59802660
1,Eyes Wide Shut,159,Drama,1999,85088435,212185957,127097522
1,Being John Malkovich,112,Fantasy|Drama|Comedy,1999,17017687,29929655,12911968
1,Analyze This,103,Comedy|Crime,1999,104724227,231552674,126828447
1,Stuart Little,84,Fantasy,1999,174104028,392893056,218789028
1,The Bone Collector,118,Drama|Mystery|Thriller|Crime,1999,95560857,198313200,102752343
1,Wild Wild West,106,Action|Adventure|Comedy|Drama|Science Fiction,1999,222538983,290746764,68207781
1,The 13th Warrior,102,Adventure|Fantasy|Action,1999,209448455,80767119,-128681336
1,End of Days,121,Action|Fantasy|Horror|Mystery,1999,130905284,277504860,146599576
1,The Cider House Rules,126,Drama,1999,31417268,115910204,84492936
1,The Iron Giant,86,Adventure|Animation|Family|Fantasy|Science Fiction,1999,91633699,30316754,-61316945
1,Deep Blue Sea,105,Horror|Action|Thriller|Science Fiction,1999,78543170,96409422,17866252
1,Payback,100,Drama|Action|Thriller|Crime,1999,117814756,211577133,93762377
1,Runaway Bride,116,Comedy|Romance,1999,91633699,405096233,313462534
1,She's All That,95,Comedy|Romance,1999,13090528,135051040,121960512
0,Double Jeopardy,105,Drama|Mystery|Thriller|Crime,1999,91633699,232803997,141170298
0,The Boondock Saints,108,Action|Thriller|Crime,1999,7854317,39888,-7814429
0,Office Space,89,Comedy|Crime,1999,13090528,16792285,3701757
0,The Virgin Suicides,97,Drama|Romance,1999,7854317,13626424,5772107
0,Bicentennial Man,131,Comedy|Science Fiction,1999,130905284,122658251,-8247033
0,The Blair Witch Project,81,Horror|Mystery,1999,32726,324645106,324612380
0,The Ninth Gate,133,Horror|Mystery|Thriller,1999,49744008,76451170,26707162
0,The Hurricane,146,Drama,1999,65452642,96812627,31359985
0,The Thirteenth Floor,100,Thriller|Science Fiction|Mystery,1999,20944845,24301372,3356527
0,Big Daddy,93,Comedy|Drama,1999,44769607,307368089,262598482
0,8MM,123,Thriller|Crime|Mystery,1999,52362113,126478983,74116870
0,Dogma,130,Fantasy|Comedy|Adventure,1999,13090528,40126252,27035724
0,The Haunting,113,Horror|Thriller|Fantasy|Mystery,1999,104724227,119371095,14646868
0,Forces of Nature,105,Comedy,1999,98178963,122904589,24725626
0,Blast from the Past,112,Comedy|Romance,1999,45816849,52706420,6889571
0,Message in a Bottle,131,Drama,1999,104724227,155620223,50895996
0,The General's Daughter,116,Crime|Drama|Mystery|Thriller,1999,78543170,195972871,117429701
0,Stigmata,103,Horror|Thriller,1999,37962532,65507271,27544739
0,Stir of Echoes,99,Horror|Mystery|Thriller,1999,15708634,27664327,11955693
0,Magnolia,188,Drama,1999,48434955,63425970,14991015
0,The Bachelor,101,Comedy,1999,66761695,48319257,-18442438
0,Virus,99,Horror|Action|Science Fiction,1999,98178963,18340733,-79838230
0,The Talented Mr. Ripley,139,Thriller|Crime|Drama,1999,52362113,168603735,116241622
0,Lake Placid,82,Horror|Comedy|Action|Science Fiction|Thriller,1999,35344426,74446377,39101951
0,Detroit Rock City,95,Comedy,1999,44507796,5520426,-38987370
0,Mystery Men,121,Adventure|Fantasy|Action|Comedy|Science Fiction,1999,89015593,38960045,-50055548
0,Fantasia 2000,74,Music|Animation|Family|Fantasy,1999,104724227,118959614,14235387
0,Go,98,Crime|Comedy|Thriller,1999,8508843,37244676,28735833
0,Never Been Kissed,107,Romance|Comedy|Drama,1999,32726321,110700355,77974034
0,Three Kings,114,Action|Adventure|Comedy,1999,98178963,141377707,43198744
0,Man on the Moon,118,Comedy|Drama|Romance,1999,107342333,62094175,-45248158
0,Brokedown Palace,100,Drama|Thriller,1999,32726321,17017687,-15708634
0,House on Haunted Hill,93,Horror|Mystery|Thriller,1999,24872004,53469679,28597675
0,The Thomas Crown Affair,113,Drama|Comedy|Crime|Romance,1999,62834536,162722051,99887515
0,Random Hearts,133,Drama|Romance,1999,83779382,97666560,13887178
0,eXistenZ,97,Action|Thriller|Science Fiction|Horror,1999,19635792,3739586,-15896206
0,The End of the Affair,102,Drama,1999,30108215,14174183,-15934032
0,Blue Streak,93,Thriller|Action|Comedy|Crime,1999,85088435,154152099,69063664
0,The Rage: Carrie 2,104,Horror|Thriller|Science Fiction,1999,27490109,23252319,-4237790
0,Black and White,98,Drama,1999,13090528,6861158,-6229370
0,The Corruptor,110,Action|Crime|Mystery|Thriller,1999,32726321,19840266,-12886055
0,Universal Soldier: The Return,82,Action|Science Fiction,1999,58907378,13964835,-44942543
0,Chill Factor,101,Action|Comedy|Thriller,1999,91633699,14745126,-76888573
0,Life,108,Comedy|Crime|Drama,1999,104724227,96012519,-8711708
0,Anywhere But Here,114,Drama|Comedy|Romance,1999,30108215,24418567,-5689648
0,The Astronaut's Wife,109,Drama|Science Fiction|Thriller,1999,98178963,25655587,-72523376
0,My Favorite Martian,94,Comedy|Drama|Family|Science Fiction,1999,85088435,48238729,-36849706
0,The Limey,89,Drama|Action|Thriller|Crime|Mystery,1999,13090528,4179939,-8910589
0,Angela's Ashes,145,Drama,1999,32,17,-15
0,The Story of Us,95,Comedy|Drama|Romance,1999,65452642,77103253,11650611
0,Drive Me Crazy,91,Drama|Comedy|Romance|Family,1999,10472422,23357926,12885504
1,Muppets from Space,87,Fantasy|Comedy|Science Fiction|Family,1999,31417268,21325748,-10091520
0,An Ideal Husband,97,Drama|Comedy|Romance,1999,18326739,24263544,5936805
0,Deuce Bigalow: Male Gigolo,88,Comedy,1999,22253898,85788866,63534968
0,Idle Hands,92,Thriller|Comedy|Horror,1999,32726321,5435488,-27290833
0,Any Given Sunday,150,Drama,1999,71997906,131207455,59209549
0,The Deep End of the Ocean,106,Drama|Mystery,1999,49744008,36812006,-12932002
0,Human Traffic,99,Comedy|Drama,1999,785431,5236211,4450780
0,In Too Deep,97,Drama|Action|Thriller|Crime,1999,9163369,18341733,9178364
0,Teaching Mrs. Tingle,96,Comedy|Thriller,1999,17017687,11711097,-5306590
0,Drop Dead Gorgeous,98,Comedy,1999,13090528,13838531,748003
0,The Best Man,120,Drama|Comedy,1999,11781475,45258905,33477430
0,Simply Irresistible,95,Comedy,1999,7854317,5758509,-2095808
0,Music of the Heart,124,Drama,1999,35344426,19451732,-15892694
0,"Mystery, Alaska",119,Comedy|Drama,1999,36653479,11635048,-25018431
0,The Mod Squad,92,Action|Mystery|Thriller,1999,65452642,17358106,-48094536
0,The Wood,106,Comedy|Drama|Romance,1999,7854317,32804393,24950076
0,200 Cigarettes,101,Comedy|Drama|Romance,1999,7854317,8970219,1115902
0,The Out-of-Towners,90,Comedy,1999,98178963,37962532,-60216431
0,Joan of Arc,148,Adventure|Drama|Action|History|War,1999,78543170,87675538,9132368
0,Beowulf,95,Action|Science Fiction|Thriller|Adventure|Horror,1999,26181056,2004488,-24176568
0,Play It to the Bone,124,Comedy|Drama,1999,31417268,11040742,-20376526
0,"Happy, Texas",98,Comedy|Crime,1999,2225389,2544339,318950
0,Ride with the Devil,138,Drama|War|Romance|Western,1999,49744008,831374,-48912634
0,Jawbreaker,87,Comedy,1999,3927158,4027719,100561
0,Dick,94,Comedy,1999,17017687,35998953,18981266
0,The King and I,87,Animation|Drama|Family,1999,32726321,15708634,-17017687
0,Outside Providence,96,Romance|Comedy|Drama,1999,9163369,9545842,382473
0,Trick,89,Comedy|Romance,1999,589073,2683028,2093955
0,Baby Geniuses,97,Comedy|Family|Science Fiction,1999,15708634,47715939,32007305
0,East Is East,97,Comedy,1999,4974400,36915290,31940890
0,Lost & Found,95,Comedy|Romance,1999,1,130,129
0,Tea with Mussolini,117,Comedy|Drama|War,1999,15708634,27492155,11783521
8,The Lord of the Rings: The Fellowship of the Ring,178,Adventure|Fantasy|Action,2001,114528394,1073079786,958551392
8,Harry Potter and the Philosopher's Stone,152,Adventure|Fantasy|Family,2001,153936014,1202518036,1048582022
4,Mulholland Drive,147,Thriller|Drama|Mystery,2001,18472321,24774263,6301942
3,Donnie Darko,113,Fantasy|Drama|Mystery,2001,7388928,1564632,-5824296
3,"Monsters, Inc.",92,Fantasy|Animation|Family|Comedy,2001,141621133,693101531,551480398
2,A.I. Artificial Intelligence,146,Drama|Science Fiction|Adventure,2001,123148811,290540745,167391934
2,Shrek,90,Adventure|Animation|Comedy|Family|Fantasy,2001,73889287,596544195,522654908
2,Bridget Jones's Diary,97,Comedy|Romance|Drama,2001,30787202,347193192,316405990
2,Ocean's Eleven,116,Thriller|Crime,2001,104676489,555052814,450376325
2,Pearl Harbor,183,History|Romance|War,2001,172408336,553210255,380801919
2,The Mummy Returns,130,Action|Adventure|Drama|Fantasy|Horror,2001,120685835,533250701,412564866
2,Atlantis: The Lost Empire,95,Animation|Family|Adventure|Science Fiction,2001,147778574,229122951,81344377
2,Lara Croft: Tomb Raider,100,Adventure|Fantasy|Action|Thriller,2001,141621133,338293898,196672765
2,A Beautiful Mind,135,Drama|Romance,2001,73889287,386123667,312234380
2,American Pie 2,108,Comedy|Romance,2001,36944643,354118835,317174192
2,The Princess Diaries,115,Comedy|Family|Romance,2001,45565060,203608276,158043216
1,Moulin Rouge!,127,Romance|Drama|Music,2001,64653126,220699214,156046088
1,Planet of the Apes,119,Thriller|Science Fiction|Action|Adventure,2001,123148811,446059453,322910642
1,The Royal Tenenbaums,110,Comedy|Drama,2001,25861250,87979050,62117800
1,Blow,124,Crime|Drama,2001,65268870,102561157,37292287
1,Enemy at the Gates,131,War,2001,86204168,119425124,33220956
1,Black Hawk Down,144,Action|History|War,2001,113296906,213034699,99737793
1,Legally Blonde,96,Comedy,2001,22166786,174593832,152427046
1,A Knight's Tale,132,Adventure|Drama|Romance|Action,2001,80046727,144684426,64637699
1,Zoolander,89,Comedy,2001,34481667,74851055,40369388
1,Not Another Teen Movie,89,Comedy,2001,19703809,81854960,62151151
1,Scary Movie 2,83,Comedy,2001,55416965,173911586,118494621
1,Rush Hour 2,90,Action|Comedy|Crime|Thriller,2001,110833930,427727597,316893667
1,Training Day,122,Action|Crime|Drama|Thriller,2001,55416965,129153834,73736869
1,The Others,101,Horror|Drama|Mystery|Thriller,2001,20935297,258547281,237611984
1,Jimmy Neutron: Boy Genius,83,Adventure|Fantasy|Animation|Action|Comedy,2001,30787202,99672007,68884805
1,Jay and Silent Bob Strike Back,104,Comedy,2001,27092738,41609718,14516980
1,Serendipity,90,Comedy|Romance,2001,34481667,95460407,60978740
1,Cats & Dogs,87,Comedy|Family,2001,73889287,114990388,41101101
1,Vanilla Sky,136,Drama|Mystery|Romance|Science Fiction|Thriller,2001,83741191,250470325,166729134
1,Kiss of the Dragon,98,Action|Crime|Thriller,2001,30787202,79354442,48567240
1,Spy Game,126,Action|Crime|Thriller,2001,113296906,176163833,62866927
1,Swordfish,99,Action|Crime|Thriller,2001,125611787,181127780,55515993
1,Shallow Hal,114,Comedy|Romance,2001,49259524,173725856,124466332
0,AntiTrust,108,Action|Crime|Drama,2001,36944643,21961127,-14983516
0,Final Fantasy: The Spirits Within,106,Adventure|Action|Animation|Fantasy|Science Fiction,2001,168713872,104838837,-63875035
0,Original Sin,118,Drama|Thriller|Mystery|Romance,2001,51722500,43597536,-8124964
0,Dr. Dolittle 2,87,Comedy|Family|Romance|Fantasy,2001,86204168,216870406,130666238
0,Behind Enemy Lines,106,Action|Drama|Thriller|War,2001,49259524,112992977,63733453
0,Jeepers Creepers,90,Horror|Thriller,2001,12314881,72926003,60611122
0,From Hell,122,Horror|Mystery|Thriller,2001,43102084,91817432,48715348
0,The Last Castle,131,Action|Drama|Thriller,2001,88667144,34041665,-54625479
0,Along Came a Spider,104,Crime|Mystery|Thriller|Action,2001,73889287,129526148,55636861
0,Super Troopers,100,Comedy|Crime|Mystery,2001,3694464,22773124,19078660
0,The Wedding Planner,103,Comedy,2001,43102084,116657057,73554973
0,Rat Race,112,Adventure|Comedy,2001,59111429,105290428,46178999
0,Gosford Park,137,Drama|Mystery|Thriller,2001,24383464,108068062,83684598
0,Jason X,91,Horror|Science Fiction,2001,13546369,19703809,6157440
0,The Mexican,123,Action|Comedy|Crime|Romance,2001,70194822,182069401,111874579
0,Joy Ride,97,Mystery|Thriller|Drama,2001,28324226,45125219,16800993
0,I Am Sam,132,Drama,2001,27092738,49593128,22500390
0,Rock Star,105,Music|Drama|Comedy,2001,70194822,20925325,-49269497
0,K-PAX,120,Drama|Science Fiction,2001,59111429,61962497,2851068
0,Don't Say a Word,113,Thriller,2001,61574405,123173554,61599149
0,Crocodile Dundee in Los Angeles,92,Adventure|Comedy,2001,26045973,48568258,22522285
0,Frailty,100,Drama|Thriller|Crime,2001,13546369,16145360,2598991
0,Angel Eyes,102,Drama|Romance|Thriller,2001,65268870,36575197,-28693673
0,Hearts in Atlantis,101,Drama|Mystery,2001,38176131,29784501,-8391630
0,The Glass House,106,Drama|Thriller,2001,36944643,29087267,-7857376
0,15 Minutes,120,Action|Crime|Thriller,2001,73889287,69406645,-4482642
0,Hardball,106,Comedy|Romance,2001,39407619,49533812,10126193
0,Evolution,101,Action|Comedy|Science Fiction,2001,98519049,121149234,22630185
0,Ali,157,Drama,2001,131769228,108018533,-23750695
0,Session 9,100,Horror|Mystery,2001,1847232,460535,-1386697
0,The Score,124,Action|Crime|Thriller,2001,83741191,87521717,3780526
0,Monster's Ball,111,Drama|Romance,2001,4925952,55305498,50379546
0,Joe Dirt,91,Mystery|Adventure|Comedy|Romance|Drama,2001,21797339,38160978,16363639
0,Exit Wounds,101,Action|Crime|Thriller,2001,61574405,98468064,36893659
0,The Tailor of Panama,109,Drama|Thriller,2001,25861250,34492088,8630838
0,Sweet November,119,Drama|Romance,2001,49259524,80975550,31716026
0,How High,93,Comedy,2001,14777857,38367547,23589690
0,Tomcats,95,Comedy|Romance,2001,13546369,28854709,15308340
0,The Majestic,152,Drama|Romance,2001,88667144,45956129,-42711015
0,3000 Miles to Graceland,125,Action|Adventure|Comedy|Thriller|Crime,2001,76352263,23053673,-53298590
0,Tape,86,Drama,2001,123148,604014,480866
0,Dil Chahta Hai,183,Drama|Romance,2001,2560263,5047869,2487606
0,Ghosts of Mars,98,Action|Horror|Science Fiction,2001,34481667,17254173,-17227494
0,Saving Silverman,90,Comedy|Romance|Crime,2001,27092738,23831227,-3261511
0,Riding in Cars with Boys,132,Comedy|Drama|Romance,2001,59111429,44017459,-15093970
0,Osmosis Jones,95,Adventure|Animation|Action|Comedy|Family,2001,92361608,16744434,-75617174
0,Head Over Heels,86,Comedy|Romance,2001,17240833,12837610,-4403223
0,The Fast and the Furious,106,Action|Crime|Thriller,2001,46796548,255267690,208471142
0,Human Nature,96,Drama|Comedy,2001,7388928,868578,-6520350
0,Save the Last Dance,112,Drama|Family|Romance|Music,2001,16009345,112112555,96103210
0,Spy Kids,88,Action|Comedy|Family|Adventure,2001,43102084,182179184,139077100
0,The Pledge,123,Crime|Drama|Mystery|Thriller,2001,43102084,36205750,-6896334
0,Bandits,123,Action|Comedy|Crime|Romance,2001,92361608,83287884,-9073724
0,The Animal,84,Action|Comedy,2001,27092738,104396624,77303886
0,Knockaround Guys,92,Crime|Thriller,2001,18472321,14777857,-3694464
0,Crazy/Beautiful,99,Drama|Romance,2001,16009345,20848013,4838668
0,Driven,116,Action,2001,115759883,67417494,-48342389
0,Out Cold,89,Comedy,2001,29555714,18204689,-11351025
0,American Outlaws,94,Action|Western,2001,43102084,16845418,-26256666
0,Hannibal,131,Crime|Drama|Thriller|Horror,2001,107139466,433104848,325965382
0,Domestic Disturbance,89,Mystery|Thriller|Crime,2001,92361608,66807360,-25554248
0,Recess: School's Out,83,Animation|Comedy|Family,2001,12314881,54753008,42438127
0,Summer Catch,108,Drama|Comedy|Romance,2001,41870595,24252792,-17617803
0,Wet Hot American Summer,97,Comedy,2001,6157440,363542,-5793898
0,The Believer,98,Drama,2001,1847232,513438,-1333794
0,Max Keeble's Big Move,86,Comedy|Family|Fantasy|Science Fiction,2001,14777857,21295361,6517504
0,Monkeybone,93,Adventure|Fantasy|Animation|Action|Comedy,2001,92361608,6661755,-85699853
0,Lovely & Amazing,91,Comedy|Drama|Romance,2001,307872,5156155,4848283
0,Corky Romano,86,Action|Comedy|Crime,2001,13546369,29529117,15982748
0,Jurassic Park III,92,Adventure|Action|Thriller|Science Fiction,2001,114528394,454149183,339620789
0,Captain Corelli's Mandolin,131,Drama|History|Romance,2001,70194822,76491292,6296470
0,Kissing Jessica Stein,97,Comedy,2001,1231488,12331412,11099924
0,The Musketeer,104,Action|Adventure|Drama,2001,49259524,33316451,-15943073
0,The Cat's Meow,114,Drama|Mystery|Thriller,2001,8620416,4491229,-4129187
0,L.I.E. Long Island Expressway,97,Drama,2001,862041,2053127,1191086
0,Novocaine,95,Comedy|Crime|Thriller,2001,7388928,2494056,-4894872
0,Sugar & Spice,81,Crime|Comedy,2001,13546369,16350409,2804040
0,Bones,96,Action|Horror|Thriller,2001,12314881,9010377,-3304504
0,The Wash,93,Action|Comedy,2001,8620416,12597299,3976883
0,Down,111,Action|Horror|Mystery|Thriller,2001,18472321,200940,-18271381
0,Made,94,Action|Comedy|Thriller,2001,6157440,6743702,586262
0,Baby Boy,130,Drama|Comedy|Crime,2001,19703809,36183151,16479342
8,The Dark Knight,152,Drama|Action|Crime|Thriller,2008,187365527,1014733032,827367505
5,WALLÂ·E,98,Animation|Family,2008,182301594,527977683,345676089
4,Iron Man,126,Action|Science Fiction|Adventure,2008,141790128,592656630,450866502
3,Taken,93,Action|Thriller|Crime,2008,25319665,229730967,204411302
3,Indiana Jones and the Kingdom of the Crystal Skull,122,Adventure|Action,2008,187365527,796694459,609328932
3,Twilight,122,Adventure|Fantasy|Drama|Romance,2008,37473105,397636870,360163765
3,Quantum of Solace,106,Adventure|Action|Thriller|Crime,2008,202557326,593584854,391027528
3,Kung Fu Panda,90,Animation|Family,2008,131662262,639822446,508160184
2,Sex Drive,109,Comedy|Adventure|Romance,2008,19242946,18995761,-247185
2,Mamma Mia!,108,Comedy|Romance,2008,52664904,617639458,564974554
2,The Curious Case of Benjamin Button,166,Fantasy|Drama|Thriller|Mystery|Romance,2008,151917995,338201950,186283955
2,The Mummy: Tomb of the Dragon Emperor,112,Adventure|Fantasy|Action|Thriller,2008,146854061,406257724,259403663
2,The Incredible Hulk,114,Science Fiction|Action|Adventure,2008,151917995,165805400,13887405
2,Gran Torino,116,Drama,2008,33421958,273410085,239988127
2,Madagascar: Escape 2 Africa,89,Family|Animation,2008,151917995,611622206,459704211
2,Hellboy II: The Golden Army,120,Adventure|Fantasy|Science Fiction,2008,86086863,162438886,76352023
2,Jumper,88,Adventure|Fantasy|Science Fiction,2008,86086863,225072774,138985911
1,Journey to the Center of the Earth,93,Action|Science Fiction|Adventure|Comedy|Family,2008,45575398,103002487,57427089
1,Wanted,110,Action|Thriller|Crime,2008,75958997,261572412,185613415
1,Slumdog Millionaire,120,Drama|Romance,2008,15191799,382742747,367550948
1,Transporter 3,104,Action|Adventure|Thriller|Crime,2008,30383599,110373030,79989431
1,Valkyrie,121,Drama|Thriller|History|War,2008,75958997,202836855,126877858
1,"10,000 BC",109,Adventure|Action|Drama|Fantasy,2008,106342596,269401244,163058648
1,Hancock,92,Fantasy|Action,2008,151917995,632008606,480090611
1,The Hurt Locker,131,Drama|Thriller|War,2008,15191799,42537038,27345239
1,What Happens in Vegas,99,Comedy|Romance,2008,35447532,172173727,136726195
1,The Chronicles of Narnia: Prince Caspian,150,Adventure|Family|Fantasy,2008,227876992,425017341,197140349
1,Tropic Thunder,107,Action|Comedy,2008,93176370,190477465,97301095
1,Eagle Eye,118,Mystery|Thriller|Action,2008,81022930,180343441,99320511
1,The Boy in the Striped Pyjamas,94,War|Drama,2008,12659832,20677622,8017790
1,Rambo,92,Action|Thriller,2008,50639331,114692303,64052972
1,Death Race,105,Action|Thriller|Science Fiction,2008,45575398,74705690,29130292
1,Step Up 2: The Streets,98,Music|Drama|Romance,2008,23294092,152745137,129451045
1,The Day the Earth Stood Still,103,Drama|Science Fiction|Thriller,2008,81022930,236074344,155051414
1,Seven Pounds,123,Drama,2008,55703264,170317989,114614725
1,Cloverfield,85,Action|Thriller|Science Fiction,2008,25319665,172947523,147627858
1,Bolt,96,Animation|Family|Adventure|Comedy,2008,151917995,313943594,162025599
1,Forgetting Sarah Marshall,111,Comedy|Romance|Drama,2008,30383599,106517925,76134326
1,Australia,165,Drama,2008,131662262,50187630,-81474632
1,Yes Man,104,Comedy|Romance,2008,70895064,228880641,157985577
1,Marley & Me,115,Comedy|Family,2008,60767198,247203368,186436170
1,Body of Lies,128,Action|Drama|Thriller,2008,70895064,114728569,43833505
1,Burn After Reading,96,Comedy|Drama,2008,37473105,165813497,128340392
1,27 Dresses,111,Comedy|Romance,2008,30383599,162308496,131924897
1,Inkheart,106,Adventure|Family|Fantasy,2008,60767198,58225482,-2541716
1,21,123,Drama|Crime,2008,35447532,70716002,35268470
1,The Bank Job,112,Thriller|Crime|Drama,2008,20255732,65651661,45395929
1,Step Brothers,98,Comedy,2008,65831131,129745707,63914576
1,Fool's Gold,112,Comedy,2008,70895064,112653311,41758247
1,Never Back Down,115,Drama|Action,2008,20255732,42159705,21903973
1,Pineapple Express,111,Action|Comedy,2008,27345239,102924282,75579043
1,The Wrestler,109,Drama|Romance,2008,6076719,45275608,39198889
1,Bedtime Stories,99,Fantasy|Comedy|Family|Romance,2008,81022930,215596389,134573459
1,Punisher: War Zone,102,Action|Crime,2008,20762125,10218382,-10543743
1,Max Payne,100,Action,2008,35447532,86509099,51061567
1,Mirrors,110,Horror|Thriller|Mystery,2008,35447532,73362657,37915125
1,Vantage Point,90,Drama|Action|Thriller|Crime,2008,40511465,153094337,112582872
1,Zack and Miri Make a Porno,102,Comedy,2008,24306879,42643493,18336614
1,Get Smart,110,Action|Comedy|Thriller,2008,81022930,233635143,152612213
1,Role Models,99,Comedy,2008,28358025,93562168,65204143
1,Babylon A.D.,101,Action|Adventure|Science Fiction|Thriller,2008,70895064,73030634,2135570
1,In Bruges,107,Comedy|Drama|Crime,2008,15191799,32411742,17219943
1,Changeling,141,Crime|Drama|Mystery,2008,55703264,114465403,58762139
1,The Spiderwick Chronicles,95,Adventure|Family|Fantasy,2008,91150797,164921838,73771041
1,Harold & Kumar Escape from Guantanamo Bay,107,Comedy|Adventure,2008,12153439,44049253,31895814
0,Street Kings,109,Action|Crime|Drama|Thriller,2008,20255732,66408286,46152554
0,Nick and Norah's Infinite Playlist,89,Comedy|Drama|Music|Romance,2008,9115079,33395562,24280483
0,Four Christmases,88,Comedy|Romance|Drama,2008,81022930,165827299,84804369
0,Stargate: The Ark of Truth,97,Adventure|Science Fiction,2008,7089506,9013801,1924295
0,The House Bunny,97,Romance|Comedy,2008,25319665,71343668,46024003
0,Star Wars: The Clone Wars,98,Thriller|Animation|Action|Science Fiction|Adventure,2008,8608686,69155951,60547265
0,Saw V,92,Horror|Thriller|Crime,2008,10938095,115313387,104375292
0,The Love Guru,87,Comedy|Romance,2008,62792771,42353789,-20438982
0,Speed Racer,135,Family|Action|Science Fiction,2008,121534396,95147016,-26387380
0,Vicky Cristina Barcelona,96,Drama|Romance,2008,15191799,97641394,82449595
0,Horton Hears a Who!,88,Animation|Comedy|Family|Adventure|Fantasy,2008,86086863,300937409,214850546
0,The Forbidden Kingdom,104,Action|Adventure|Fantasy,2008,55703264,129542119,73838855
0,Righteous Kill,101,Action|Adventure|Crime|Drama|Thriller,2008,60767198,74110222,13343024
0,Transsiberian,111,Thriller|Crime|Mystery,2008,15191799,6002188,-9189611
0,Traitor,114,Drama|Action|Thriller|Crime,2008,22281305,23831711,1550406
0,You Don't Mess With the Zohan,113,Comedy|Action,2008,91150797,204174046,113023249
0,Defiance,137,Action|Drama|History|War,2008,32409172,51809322,19400150
0,Untraceable,101,Drama,2008,35447532,32898763,-2548769
0,The Strangers,90,Thriller|Horror|Mystery,2008,9115079,83444650,74329571
0,Milk,128,History|Drama,2008,20255732,55284562,35028830
0,Outlander,115,Fantasy|Action|Science Fiction,2008,50639331,7123620,-43515711
0,The X Files: I Want to Believe,104,Drama|Mystery|Science Fiction|Thriller,2008,30383599,69243648,38860049
0,Doubt,104,Drama|Mystery,2008,20255732,51558166,31302434
0,City of Ember,90,Adventure|Family|Fantasy,2008,55703264,18097532,-37605732
0,Made of Honor,101,Comedy|Romance,2008,40511465,85683451,45171986
0,Deception,107,Drama|Thriller|Crime|Mystery,2008,25319665,17968149,-7351516
0,RockNRolla,114,Action|Crime|Thriller,2008,18230159,26068130,7837971
0,The Eye,98,Drama|Horror|Thriller,2008,12153439,57029778,44876339
0,Elegy,112,Drama|Romance,2008,13166226,15084795,1918569
0,Bangkok Dangerous,99,Action|Crime|Thriller,2008,45575398,43030660,-2544738
0,Meet the Spartans,84,Comedy,2008,30383599,85729179,55345580
0,Stop-Loss,113,Drama|War,2008,25319665,11350431,-13969234
0,Blindness,121,Drama|Mystery|Science Fiction|Thriller,2008,25319665,20098729,-5220936
0,The Spirit,103,Action|Comedy|Thriller|Crime|Science Fiction,2008,60767198,39530416,-21236782
0,Nothing But the Truth,108,Drama|Thriller,2008,11647046,189089,-11457957
0,Appaloosa,115,Drama|Western|Crime,2008,20255732,20469829,214097
0,The Informers,98,Action|Adventure|Crime|Drama|Thriller,2008,18230159,387060,-17843099
0,The Happening,91,Thriller|Science Fiction,2008,60767198,165493183,104725985
0,Doomsday,105,Action|Thriller|Science Fiction,2008,30383599,22495435,-7888164
0,The Secret of Moonacre,103,Adventure|Fantasy|Drama|Science Fiction|Romance,2008,12153439,7160735,-4992704
0,Vals Im Bashir,90,Drama|Animation|War,2008,2025573,11268111,9242538
0,Sex and the City,145,Comedy|Drama|Romance,2008,65831131,420562471,354731340
0,The Rocker,102,Comedy|Music,2008,15191799,8874937,-6316862
0,The Tale of Despereaux,100,Animation|Comedy|Family,2008,60767198,51527692,-9239506
0,Superhero Movie,85,Action|Comedy|Science Fiction,2008,35447532,26202647,-9244885
0,The Secret Life of Bees,114,Adventure|Drama,2008,11140652,38592634,27451982
0,The Other Man,90,Drama|Thriller|Mystery|Romance,2008,15191799,1158482,-14033317
0,Beverly Hills Chihuahua,91,Adventure|Comedy|Family,2008,20255732,151190415,130934683
0,Revolutionary Road,119,Drama|Romance,2008,35447532,76187576,40740044
0,Sunshine Cleaning,102,Comedy|Drama,2008,5063933,16381192,11317259
0,Ong Bak 2,98,Adventure|Action|Thriller,2008,8608686,9050932,442246
0,Pride and Glory,130,Thriller|Crime|Drama,2008,30383599,31546610,1163011
0,"Surfer, Dude",85,Comedy,2008,6076719,70385,-6006334
0,Baby Mama,99,Comedy,2008,30383599,64649663,34266064
0,College,94,Comedy,2008,7089506,6309940,-779566
0,Brideshead Revisited,133,Drama|Romance,2008,20255732,13373129,-6882603
0,The Brothers Bloom,114,Adventure|Comedy|Drama|Romance,2008,20255732,5601483,-14654249
0,Meet Dave,90,Comedy|Science Fiction|Adventure|Family,2008,60767198,51297723,-9469475
0,Quarantine,89,Horror|Science Fiction|Thriller,2008,12153439,41377822,29224383
0,Justice League: The New Frontier,75,Action|Adventure|Animation|Science Fiction,2008,3544753,5298016,1753263
0,Two Lovers,110,Drama|Romance,2008,12153439,3188436,-8965003
0,Passengers,93,Drama|Mystery|Thriller|Romance,2008,25319665,2025573,-23294092
0,The Sisterhood of the Traveling Pants 2,117,Adventure|Comedy|Drama|Family,2008,27345239,44919535,17574296
0,The Express,130,Drama,2008,40511465,9918721,-30592744
0,Surveillance,97,Thriller,2008,3544753,1129756,-2414997
0,The Women,114,Comedy|Drama|Romance,2008,16204586,50646974,34442388
0,Gong fu guan lan,100,Action|Adventure|Comedy,2008,10127866,23189500,13061634
0,ÐÐ´Ð¼Ð¸Ñ€Ð°Ð»ÑŠ,123,Action|Drama|History|War,2008,2025573,38623507,36597934
0,Space Chimps,81,Animation|Family,2008,37473105,64616136,27143031
0,Lakeview Terrace,110,Drama|Crime|Thriller,2008,20255732,27993450,7737718
0,Jodhaa Akbar,213,Action|Adventure|Drama|Foreign|History,2008,8483911,13166226,4682315
0,Choke,92,Comedy|Drama,2008,3038359,3879111,840752
0,"War, Inc.",106,Action|Adventure|Comedy|Thriller,2008,5063933,1312757,-3751176
0,The Wackness,99,Drama,2008,6076719,2937055,-3139664
0,What Just Happened,104,Comedy|Drama,2008,25319665,6758752,-18560913
0,Assassination of a High School President,93,Comedy|Crime|Mystery|Thriller,2008,11647046,70453,-11576593
0,Disaster Movie,87,Action|Comedy,2008,25319665,14289694,-11029971
0,Miracle at St. Anna,160,Thriller|Drama|Action|Crime|War,2008,45575398,9443053,-36132345
0,My Best Friend's Girl,101,Comedy,2008,20255732,37088761,16833029
0,Paris,130,Drama,2008,19242946,23851125,4608179
0,The Midnight Meat Train,98,Mystery|Drama|Crime|Thriller|Horror,2008,15191799,3578405,-11613394
0,Mutant Chronicles,111,Action|Adventure|Horror|Science Fiction,2008,8102293,2059162,-6043131
0,Swing Vote,120,Drama|Comedy,2008,21268519,17825044,-3443475
0,W.,131,Drama|History,2008,25420944,29883752,4462808
0,Fireproof,122,Drama,2008,506393,33884110,33377717
0,Smart People,95,Comedy|Drama|Romance,2008,7089506,10705118,3615612
0,Nim's Island,96,Adventure|Comedy|Family|Fantasy,2008,37473105,101355981,63882876
0,Igor,87,Animation|Comedy|Family|Fantasy,2008,25319665,30383599,5063934
0,How to Lose Friends & Alienate People,110,Comedy|Romance|Drama,2008,27345239,17507332,-9837907
0,Oorlogswinter,103,Drama|History|War,2008,4051146,536825,-3514321
0,While She Was Out,108,Action|Adventure|Drama|Horror|Thriller,2008,6076719,396414,-5680305
0,Welcome Home Roscoe Jenkins,114,Comedy|Drama,2008,35447532,44208931,8761399
0,Ghajini,183,Action|Drama|Foreign|Mystery|Thriller,2008,9216358,76971784,67755426
0,Dr. Horrible's Sing-Along Blog,42,Adventure|Action|Comedy|Science Fiction|Music,2008,202557,3,-202554
0,Jaane Tu... Ya Jaane Na,155,Drama|Comedy|Romance,2008,2329409,11241931,8912522
0,Bottle Shock,110,Comedy|Drama,2008,5063933,4092253,-971680
0,Julia,138,Drama,2008,6076719,1316622,-4760097
0,Kismat Konnection,153,Drama|Comedy|Romance|Foreign,2008,4233448,11140652,6907204
0,Sleep Dealer,90,Drama|Science Fiction|Thriller,2008,2531966,108934,-2423032
0,The Yellow Handkerchief,102,Drama|Romance,2008,15191799,321053,-14870746
0,It's Alive,80,Horror,2008,11140652,15698192,4557540
0,Expelled: No Intelligence Allowed,90,Documentary,2008,3544753,7798457,4253704
7,Captain America: The First Avenger,124,Action|Adventure|Science Fiction,2011,135715726,359229613,223513887
5,Drive,100,Drama|Action|Thriller|Crime,2011,14540970,73844056,59303086
5,Harry Potter and the Deathly Hallows: Part 2,130,Adventure|Family|Fantasy,2011,121174755,1287183998,1166009243
4,Pirates of the Caribbean: On Stranger Tides,136,Adventure|Action|Fantasy,2011,368371256,990417500,622046244
4,Rise of the Planet of the Apes,105,Thriller|Action|Drama|Science Fiction,2011,90154017,468083718,377929701
4,Thor,115,Adventure|Fantasy|Action,2011,145409706,430524218,285114512
3,In Time,109,Action|Thriller|Science Fiction,2011,38775921,168607979,129832058
3,Drive Angry,105,Fantasy|Thriller|Action|Crime,2011,48469902,28046043,-20423859
3,The Mechanic,93,Action|Thriller|Crime,2011,38775921,49507940,10732019
2,Source Code,93,Thriller|Science Fiction|Mystery,2011,31020737,142824028,111803291
2,Mission: Impossible - Ghost Protocol,133,Action|Thriller|Adventure,2011,140562716,673453790,532891074
2,"Crazy, Stupid, Love.",118,Comedy|Drama|Romance,2011,48469902,138479670,90009768
2,The Girl with the Dragon Tattoo,158,Thriller|Crime|Mystery|Drama,2011,87245823,225498881,138253058
2,Limitless,105,Thriller|Mystery|Science Fiction,2011,26173747,156896544,130722797
2,Kung Fu Panda 2,91,Animation|Family,2011,145409706,645320794,499911088
2,Just Go With It,117,Romance|Comedy,2011,77551843,208341483,130789640
2,Horrible Bosses,98,Comedy|Crime,2011,33928931,113419571,79490640
2,Real Steel,127,Action|Science Fiction|Drama,2011,106633784,290110305,183476521
2,Friends with Benefits,109,Comedy,2011,33928931,145878667,111949736
2,Bad Teacher,92,Comedy,2011,19387960,209581425,190193465
2,Sherlock Holmes: A Game of Shadows,129,Adventure|Action|Crime|Mystery,2011,121174755,324375126,203200371
2,Cars 2,106,Animation|Family|Adventure|Comedy,2011,193879608,542719816,348840208
2,Green Lantern,114,Adventure|Action|Thriller|Science Fiction,2011,193879608,213123295,19243687
2,The Hangover Part II,102,Comedy,2011,77551843,246669134,169117291
2,No Strings Attached,108,Comedy|Romance,2011,24234951,143258069,119023118
2,The Adventures of Tintin,107,Adventure|Animation|Action|Family|Mystery,2011,126021745,360557976,234536231
2,Bridesmaids,125,Romance|Comedy,2011,31505436,279558422,248052986
2,Hall Pass,105,Comedy,2011,34898329,80615852,45717523
2,Super 8,112,Thriller|Science Fiction|Mystery,2011,48469902,252136540,203666638
1,Sucker Punch,110,Action|Fantasy|Thriller,2011,79490639,87044675,7554036
1,Red Riding Hood,100,Thriller,2011,40714717,86433625,45718908
1,The Twilight Saga: Breaking Dawn - Part 1,117,Adventure|Fantasy|Romance,2011,106633784,690378003,583744219
1,Shame,100,Drama,2011,6301087,17152213,10851126
1,Mr. Popper's Penguins,94,Comedy|Family,2011,53316892,181628117,128311225
1,The Tree of Life,139,Drama|Fantasy,2011,31020737,53001087,21980350
1,I Am Number Four,109,Action|Thriller|Science Fiction|Adventure,2011,48469902,140071066,91601164
1,Rio,96,Animation|Adventure|Comedy|Family,2011,87245823,469804957,382559134
1,The Artist,100,Drama|Comedy|Romance,2011,14540970,129349549,114808579
1,Zookeeper,102,Comedy|Romance|Family,2011,77551843,164654932,87103089
1,Cowboys & Aliens,119,Action|Science Fiction|Thriller|Western,2011,158011880,169472419,11460539
1,War Horse,146,Drama|War,2011,63980270,172150434,108170164
1,50/50,100,Comedy|Drama,2011,7755184,37988560,30233376
1,Rango,107,Animation|Comedy|Family|Western|Adventure,2011,130868735,238204949,107336214
1,The Change-Up,112,Comedy,2011,50408698,73141505,22732807
1,Hugo,126,Adventure|Drama|Family,2011,164797667,180085229,15287562
1,The Lincoln Lawyer,119,Crime|Drama|Thriller,2011,38775921,82799096,44023175
1,Ghost Rider: Spirit of Vengeance,95,Action|Fantasy|Thriller,2011,55255688,144651011,89395323
1,One Day,107,Drama|Romance,2011,14540970,57572000,43031030
1,Killer Elite,116,Action|Adventure|Thriller,2011,63980270,56009013,-7971257
1,The Rite,114,Drama|Thriller|Horror,2011,35867727,93108387,57240660
1,Winnie the Pooh,63,Animation|Family,2011,29081941,14017495,-15064446
1,The Three Musketeers,110,Adventure|Action|Thriller|Comedy,2011,72704853,128226625,55521772
1,Chalet Girl,96,Comedy|Romance,2011,7755184,1695920,-6059264
1,Midnight in Paris,94,Fantasy|Comedy|Romance,2011,29081941,146494675,117412734
1,Priest,87,Action|Fantasy|Horror|Science Fiction|Thriller,2011,58163882,75912718,17748836
1,Young Adult,94,Comedy|Drama|Romance,2011,11632776,22237047,10604271
1,Warrior,140,Action|Drama,2011,24234951,22351522,-1883429
1,Abduction,106,Thriller|Action|Mystery,2011,33928931,79575127,45646196
1,Unknown,113,Action|Mystery|Thriller,2011,29081941,126784077,97702136
1,The Adjustment Bureau,106,Thriller|Romance|Fantasy,2011,48663781,123956325,75292544
1,Immortals,110,Fantasy|Action|Drama,2011,72704853,219960309,147255456
1,Like Crazy,90,Drama|Romance,2011,242349,3433950,3191601
1,Larry Crowne,98,Comedy|Romance|Drama,2011,29081941,35053796,5971855
1,Paul,104,Adventure|Comedy|Science Fiction,2011,38775921,94566766,55790845
1,Colombiana,108,Action|Thriller|Crime|Drama,2011,38775921,59100179,20324258
1,Battle: Los Angeles,116,Action|Science Fiction,2011,67857862,196270877,128413015
1,Final Destination 5,92,Horror|Mystery,2011,45561708,153055972,107494264
1,Machine Gun Preacher,129,Action|Thriller|Crime,2011,29081941,2450545,-26631396
1,Jack and Jill,91,Comedy,2011,76582445,145093477,68511032
1,What's Your Number?,106,Comedy|Romance,2011,19387960,29494997,10107037
1,Season of the Witch,95,Adventure|Fantasy|Action,2011,38775921,85403967,46628046
1,My Week with Marilyn,99,Drama,2011,6204147,33984861,27780714
1,We Bought a Zoo,124,Drama|Comedy|Family,2011,48469902,116407101,67937199
1,The Darkest Hour,89,Horror|Action|Thriller|Science Fiction,2011,29081941,62649079,33567138
1,The Help,146,Drama,2011,24234951,120469153,96234202
1,The Grey,117,Action|Drama|Thriller,2011,24234951,74913462,50678511
1,Moneyball,133,Drama,2011,48469902,106833690,58363788
1,We Need to Talk About Kevin,112,Drama|Thriller,2011,6785786,5854138,-931648
1,The Roommate,91,Thriller|Drama|Horror,2011,15510368,39253601,23743233
1,Puss in Boots,90,Action|Adventure|Animation|Family|Fantasy,2011,126021745,538003773,411982028
1,The Green Hornet,119,Action|Crime|Comedy,2011,116327765,220845594,104517829
1,Something Borrowed,112,Comedy|Drama|Romance,2011,33928931,58068797,24139866
1,Conan the Barbarian,113,Adventure|Fantasy|Action,2011,87245823,47301797,-39944026
1,Johnny English Reborn,101,Crime|Adventure|Action|Comedy|Thriller,2011,43622911,155179867,111556956
1,Contagion,106,Drama|Thriller|Science Fiction,2011,58163882,131312814,73148932
1,The Big Year,100,Comedy,2011,39745319,7220449,-32524870
1,Beastly,86,Drama|Fantasy|Romance,2011,16479766,41844620,25364854
1,A Very Harold & Kumar Christmas,108,Comedy,2011,18418562,34304294,15885732
1,The Thing,103,Horror|Science Fiction|Mystery|Thriller,2011,33928931,27267877,-6661054
1,Tower Heist,104,Action|Comedy,2011,72704853,148250646,75545793
1,New Year's Eve,118,Comedy|Romance,2011,54286290,137697794,83411504
1,Your Highness,102,Adventure|Fantasy|Action|Comedy,2011,48372962,25322264,-23050698
0,Apollo 18,86,Horror|Thriller|Science Fiction,2011,4846990,24780648,19933658
0,Fright Night,106,Horror|Comedy,2011,16479766,24159567,7679801
0,Happy Feet Two,100,Music|Family|Animation|Comedy,2011,126021745,145803733,19781988
0,Scream 4,111,Horror|Mystery,2011,38775921,94166052,55390131
0,Mars Needs Moms,88,Adventure|Animation|Family,2011,145409706,37799503,-107610203
0,Attack the Block,88,Action|Comedy|Science Fiction,2011,13911376,3843354,-10068022
0,Diary of a Wimpy Kid: Rodrick Rules,99,Family|Comedy,2011,20357358,70201279,49843921
0,Extremely Loud & Incredibly Close,129,Drama,2011,38775921,53557187,14781266
0,Alvin and the Chipmunks: Chipwrecked,87,Comedy|Fantasy|Family|Music|Animation,2011,72704853,332208283,259503430
0,The Beaver,91,Drama,2011,20357358,941107,-19416251
0,Straw Dogs,110,Thriller,2011,24234951,10008492,-14226459
0,The Best Exotic Marigold Hotel,124,Drama|Comedy,2011,9693980,132648701,122954721
0,The Smurfs,103,Animation|Family|Adventure|Comedy|Fantasy,2011,106633784,546497490,439863706
0,Hanna,111,Action|Thriller|Adventure,2011,29081941,61830221,32748280
0,A Few Best Men,97,Comedy,2011,12086831,28119728,16032897
0,Flypaper,87,Mystery|Comedy|Crime,2011,4846990,3045997,-1800993
0,Margin Call,107,Thriller|Drama,2011,3392893,18907177,15514284
0,Gnomeo & Juliet,84,Animation|Family,2011,34898329,183906860,149008531
0,Blitz,97,Crime|Action|Thriller,2011,15292203,719172,-14573031
0,The Descendants,115,Comedy|Drama,2011,19387960,171819196,152431236
0,Hop,95,Animation,2011,61072076,178324379,117252303
0,The Rum Diary,120,Drama|Comedy,2011,43622911,23265553,-20357358
0,The Guard,96,Action|Comedy|Thriller|Crime,2011,5816388,18961691,13145303
0,Our Idiot Brother,90,Comedy|Drama,2011,9693980,16744987,7051007
0,The Ledge,101,Drama|Thriller,2011,9693980,592288,-9101692
0,Footloose,113,Drama|Music|Romance,2011,23265553,61598777,38333224
0,Trespass,91,Crime|Drama|Thriller,2011,34898329,9318308,-25580021
0,Carnage,80,Comedy|Drama,2011,24234951,26758361,2523410
0,Another Earth,92,Drama|Science Fiction,2011,96939,1722557,1625618
0,The Ides of March,101,Drama,2011,12117475,73667524,61550049
0,Transformers: Dark of the Moon,154,Action|Science Fiction|Adventure,2011,189032618,1089358138,900325520
0,Paranormal Activity 3,83,Horror,2011,4846990,199408878,194561888
0,The Dilemma,111,Comedy|Drama,2011,67857862,65058885,-2798977
0,Take Me Home Tonight,97,Comedy|Drama|Romance,2011,18418562,6716055,-11702507
0,A Lonely Place to Die,99,Adventure|Action|Thriller|Crime,2011,3877592,24569393,20691801
0,The Muppets,103,Comedy|Family|Music,2011,43622911,160129276,116506365
0,Spy Kids: All the Time in the World,89,Family|Comedy|Action,2011,26173747,82945874,56772127
0,Trust,104,Crime|Drama|Thriller,2011,9209281,116327,-9092954
0,Seeking Justice,105,Action|Drama|Thriller,2011,16479766,11977686,-4502080
0,Arthur,110,Comedy|Romance,2011,38775921,44335804,5559883
0,The Eagle,114,Adventure|Drama,2011,24234951,26292052,2057101
0,The Sitter,81,Comedy,2011,24234951,33872888,9637937
0,Rundskop,124,Crime|Drama,2011,1938796,40782,-1898014
0,W.E.,119,Drama|Romance,2011,14540970,841863,-13699107
0,The Innkeepers,102,Horror|Thriller,2011,727048,75996,-651052
0,Restless,91,Drama|Romance,2011,7755184,158268,-7596916
0,Coriolanus,123,Drama|Thriller,2011,7464364,1039778,-6424586
0,J. Edgar,137,Drama|Crime|History,2011,33928931,82016919,48087988
0,Sanctum,108,Action|Thriller,2011,29081941,105285652,76203711
0,I Don't Know How She Does It,89,Comedy,2011,23265553,29616559,6351006
0,A Dangerous Method,99,Drama|Thriller,2011,14540970,26621648,12080678
0,Soul Surfer,106,Action|Drama,2011,17449164,45647974,28198810
0,30 Minutes or Less,83,Action|Comedy|Adventure,2011,27143145,39306608,12163463
0,The Awakening,107,Drama|Horror|Thriller,2011,4651399,203278,-4448121
0,Hoodwinked Too! Hood VS. Evil,86,Comedy|Animation|Family,2011,29081941,13108034,-15973907
0,5 Days of War,113,War|Drama,2011,19387960,16944,-19371016
0,Water for Elephants,120,Drama|Romance,2011,36837125,110662825,73825700
0,Dream House,92,Drama|Thriller|Mystery,2011,48469902,37324093,-11145809
0,A Better Life,98,Drama,2011,9693980,1705415,-7988565
0,"Love, Wedding, Marriage",90,Comedy|Romance,2011,0,1335,1335
0,Rampart,108,Crime|Drama|Action|Thriller,2011,11632776,942751,-10690025
0,Take Shelter,120,Thriller|Drama,2011,4846990,3004468,-1842522
0,Prom,104,Comedy,2011,7755184,9820002,2064818
0,Pina,106,Documentary,2011,4185808,14177277,9991469
0,Courageous,129,Drama,2011,969398,33465773,32496375
0,Black Gold,130,Adventure|Drama,2011,38775921,5279341,-33496580
0,Killer Joe,102,Drama|Thriller,2011,9693980,3552910,-6141070
0,"Big Mommas: Like Father, Like Son",107,Crime|Comedy|Action,2011,31020737,81056618,50035881
0,From Prada to Nada,107,Comedy|Drama|Romance,2011,90,2423495,2423405
0,Dolphin Tale,113,Drama|Family,2011,35867727,92484835,56617108
0,Xin shao lin si,131,Action|Drama,2011,28112543,32632724,4520181
0,Fast Five,130,Action|Thriller|Crime,2011,121174755,606976636,485801881
0,Nuit Blanche,98,Action|Comedy|Thriller|Romance,2011,2423495,3255,-2420240
0,In the Land of Blood and Honey,127,Drama|Romance|War,2011,9693980,294577,-9399403
0,Another Happy Day,119,Comedy|Drama,2011,3877592,344803,-3532789
0,Jumping the Broom,112,Comedy,2011,6398027,36556591,30158564
0,Silent House,85,Horror|Mystery,2011,1938796,12700735,10761939
0,Wuthering Heights,129,Drama|Romance,2011,7755184,97826,-7657358
0,Your Sister's Sister,90,Drama|Comedy,2011,121174,3102073,2980899
0,Monte Carlo,109,Adventure|Comedy|Romance,2011,19387960,16891760,-2496200
0,Win Win,106,Drama|Comedy,2011,10499717,10328339,-171378
0,Margaret,149,Drama,2011,13571572,45072,-13526500
0,The Double,98,Drama|Action|Thriller|Crime|Mystery,2011,16479766,3583120,-12896646
0,L!fe Happens,100,Comedy,2011,901540,29959,-871581
0,The Iron Lady,105,History|Drama,2011,12602174,111438799,98836625
0,Red State,88,Horror|Action|Thriller,2011,3877592,1070876,-2806716
0,The Devil's Double,109,Drama|Action|Thriller|Crime|War,2011,18515502,5552918,-12962584
0,The Music Never Stopped,105,Drama,2011,3877592,246129,-3631463
0,Shark Night,91,Horror|Thriller,2011,27143145,9816568,-17326577
0,Hobo with a Shotgun,86,Action|Comedy|Thriller,2011,2908194,652063,-2256131
0,Madea's Big Happy Family,106,Comedy|Drama,2011,24234951,51585191,27350240
0,Atlas Shrugged Part I,97,Drama|Thriller|Science Fiction|Mystery,2011,14540970,4485768,-10055202
0,This Must Be the Place,118,Drama,2011,24234951,11430151,-12804800
0,Albert Nobbs,113,Drama,2011,7755184,5462391,-2292793
0,Snow Flower and the Secret Fan,104,History|Drama,2011,129904,1291462,1161558
0,The Good Doctor,93,Drama|Thriller,2011,5816388,5046,-5811342
0,Weekend,96,Drama|Romance,2011,7755,455565,447810
0,Kill List,95,Horror|Thriller|Crime,2011,484699,166503,-318196
0,Justin Bieber: Never Say Never,105,Documentary|Music|Family,2011,12602174,95429437,82827263
0,Bellflower,106,Action|Drama|Romance,2011,16479,98137,81658
0,"Jeff, Who Lives at Home",83,Drama|Comedy,2011,9693980,4282393,-5411587
0,The Divide,112,Science Fiction,2011,2908194,21326,-2886868
0,Life in a Day,95,Documentary|Drama,2011,43818,218949,175131
0,X-Men: First Class,132,Action|Science Fiction|Adventure,2011,155103686,333880181,178776495
0,Louis C.K.: Live at the Beacon Theater,62,Comedy,2011,242349,969398,727049
0,Glee: The Concert Movie,84,Documentary|Music|Family,2011,8724582,18092106,9367524
0,William & Kate,83,Drama|Romance,2011,19,14,-5
8,The Lord of the Rings: The Two Towers,179,Adventure|Fantasy|Action,2002,95768650,1122902454,1027133804
6,Harry Potter and the Chamber of Secrets,161,Adventure|Fantasy|Family,2002,121226139,1062775601,941549462
4,Ice Age,81,Animation|Comedy|Family|Adventure,2002,71523422,464607829,393084407
3,The Bourne Identity,119,Action|Drama|Mystery|Thriller,2002,72735683,259465426,186729743
3,Resident Evil,100,Horror|Action|Science Fiction,2002,40004625,124185364,84180739
3,Spider-Man,121,Fantasy|Action,2002,168504333,996125553,827621220
3,Star Wars: Episode II - Attack of the Clones,142,Adventure|Action|Science Fiction,2002,145471367,787240522,641769155
2,Catch Me If You Can,141,Drama|Crime,2002,63037592,426854586,363816994
2,Men in Black II,88,Action|Adventure|Comedy|Science Fiction,2002,169716595,535599877,365883282
2,The Pianist,150,Drama|War,2002,42429148,145559349,103130201
2,Minority Report,145,Action|Thriller|Science Fiction|Mystery,2002,123650662,434441662,310791000
2,Lilo & Stitch,85,Animation,2002,96980911,176713194,79732283
1,The Transporter,92,Action|Crime|Thriller,2002,25457489,53253348,27795859
1,xXx,124,Action,2002,84858297,336339962,251481665
1,Treasure Planet,95,Adventure|Animation|Family|Fantasy|Science Fiction,2002,169716595,132837318,-36879277
1,Die Another Day,133,Adventure|Action|Thriller,2002,169716595,523661907,353945312
1,28 Days Later...,113,Horror|Thriller|Science Fiction,2002,6061306,100278123,94216817
1,Maid in Manhattan,105,Comedy|Drama|Romance,2002,66674376,187787403,121113027
1,Blade II,117,Science Fiction|Horror|Action|Thriller,2002,65462115,187912677,122450562
1,Gangs of New York,167,Drama|History|Crime,2002,121226139,234902925,113676786
1,Panic Room,112,Crime|Drama|Thriller,2002,58188546,238085004,179896458
1,Stuart Little 2,78,Family|Adventure|Animation|Comedy,2002,145471367,206032074,60560707
1,National Lampoonâ€™s Van Wilder,92,Comedy|Romance,2002,6061306,46399890,40338584
1,8 Mile,110,Drama,2002,49702717,260636199,210933482
1,Mr. Deeds,96,Comedy|Romance,2002,60613069,207623445,147010376
1,Bend It Like Beckham,112,Comedy|Drama|Romance,2002,4243107,92833330,88590223
1,Two Weeks Notice,101,Romance|Comedy,2002,72735683,113170563,40434880
1,Signs,106,Drama|Thriller|Science Fiction|Mystery,2002,87282820,494903188,407620368
1,The Ring,115,Horror|Mystery|Thriller,2002,58188546,302276085,244087539
1,A Walk to Remember,101,Drama|Family|Romance,2002,13334875,49977984,36643109
1,My Big Fat Greek Wedding,95,Comedy|Drama|Romance,2002,6061306,447014168,440952862
1,About a Boy,101,Drama|Comedy|Romance,2002,32731057,156381719,123650662
1,Collateral Damage,108,Action|Thriller|Drama,2002,103042218,95019997,-8022221
1,Phone Booth,81,Thriller|Drama,2002,15759398,118604185,102844787
1,Star Trek: Nemesis,117,Science Fiction|Action|Adventure|Thriller,2002,72735683,81600740,8865057
1,Equilibrium,107,Action|Science Fiction|Thriller,2002,24245227,6497290,-17747937
1,The Good Girl,93,Drama|Comedy|Romance,2002,9698091,20434028,10735937
1,The Hours,114,Drama,2002,30306534,131949890,101643356
1,Road to Perdition,117,Thriller|Crime|Drama,2002,96980911,219421104,122440193
1,Austin Powers in Goldmember,94,Science Fiction|Comedy|Crime|Action,2002,76372467,359597833,283225366
1,The Santa Clause 2,104,Fantasy|Comedy|Family,2002,78796990,209545522,130748532
1,Insomnia,118,Crime|Mystery|Thriller,2002,55764024,137852098,82088074
1,Ghost Ship,91,Horror|Mystery|Thriller,2002,42429148,82857925,40428777
1,Scooby-Doo,88,Mystery|Adventure|Comedy,2002,101829957,334160705,232330748
1,Spirit: Stallion of the Cimarron,83,Western|Animation|Adventure|Comedy|Family,2002,96980911,148579046,51598135
1,D-Tox,96,Action|Thriller,2002,66674376,7778235,-58896141
1,The Scorpion King,92,Action|Fantasy|Adventure,2002,72735683,200427031,127691348
1,I Spy,97,Action|Adventure|Comedy|Thriller,2002,84858297,40684870,-44173427
1,Bowling for Columbine,120,Documentary,2002,4849045,43113437,38264392
1,25th Hour,135,Crime|Drama,2002,18183920,15833155,-2350765
0,Ken Park,97,Drama,2002,1575939,542779,-1033160
0,The Sum of All Fears,124,Thriller|Action|Drama,2002,82,233,151
0,We Were Soldiers,138,Action|History|War,2002,90919604,138998841,48079237
0,Jackass: The Movie,87,Comedy,2002,6061306,77926965,71865659
0,Frida,123,Drama|Romance,2002,14547136,68248466,53701330
0,Murder by Numbers,120,Crime|Drama|Thriller,2002,60613069,68752370,8139301
0,Adaptation.,114,Comedy|Crime|Drama,2002,23032966,39763595,16730629
0,Sweet Home Alabama,108,Comedy|Romance,2002,36367841,218961591,182593750
0,Barbershop,102,Comedy|Drama,2002,14547136,91867158,77320022
0,Dark Blue,118,Action|Crime|Drama|Thriller,2002,18183920,11198228,-6985692
0,The Time Machine,96,Science Fiction|Adventure|Action,2002,96980911,149992103,53011192
0,Undisputed,96,Action|Adventure|Drama|Thriller,2002,24245227,15030378,-9214849
0,The Sweetest Thing,84,Romance|Comedy,2002,52127239,83278442,31151203
0,Windtalkers,134,Drama|Action|History|War,2002,139410060,94105748,-45304312
0,John Q,116,Drama|Thriller|Crime,2002,43641410,123947387,80305977
0,Unfaithful,124,Drama,2002,60613069,144426136,83813067
0,Changing Lanes,89,Action|Adventure|Crime|Thriller,2002,54551762,115086961,60535199
0,Punch-Drunk Love,95,Comedy|Drama|Romance,2002,30306534,20608443,-9698091
0,K-19: The Widowmaker,138,Thriller|Drama|History,2002,121226139,42633979,-78592160
0,Queen of the Damned,101,Drama|Fantasy|Horror,2002,42429148,55132569,12703421
0,Spy Kids 2: Island of Lost Dreams,100,Action|Adventure|Comedy|Family,2002,46065932,145136004,99070072
0,Enough,114,Action|Drama|Thriller,2002,46065932,62796579,16730647
0,Friday After Next,85,Comedy|Drama,2002,24245227,40643287,16398060
0,Return to Never Land,72,Adventure|Fantasy|Animation|Family,2002,24245227,133182288,108937061
0,Life or Something Like It,103,Comedy|Drama|Romance,2002,48490455,20454087,-28036368
0,Slackers,86,Comedy|Romance,2002,16971659,7775341,-9196318
0,Chicago,113,Action|Comedy|Crime|Drama|Music,2002,54551762,371893588,317341826
0,One Hour Photo,96,Horror|Thriller,2002,14547136,63308297,48761161
0,Femme Fatale,114,Thriller|Crime|Romance,2002,42429148,20413160,-22015988
0,City By The Sea,108,Drama|Thriller|Mystery,2002,48490455,27195769,-21294686
0,Reign of Fire,101,Action|Fantasy|Science Fiction|Thriller,2002,72735683,52202378,-20533305
0,Showtime,95,Action|Comedy,2002,103042218,94243300,-8798918
0,High Crimes,115,Drama|Mystery|Thriller|Crime,2002,50914978,77320225,26405247
0,Moonlight Mile,117,Romance|Drama,2002,25457489,12136009,-13321480
0,Hart's War,125,Drama|War,2002,84858297,39140336,-45717961
0,About Schmidt,125,Drama|Comedy,2002,36367841,128299146,91931305
0,Blue Crush,104,Adventure,2002,30306534,62846878,32540344
0,Blood Work,110,Crime|Drama|Mystery|Thriller,2002,60613069,31760662,-28852407
0,Solaris,99,Drama|Science Fiction|Mystery|Romance,2002,56976285,36371185,-20605100
0,The Four Feathers,132,War|Adventure|Drama|Romance,2002,42429148,36225576,-6203572
0,The Quiet American,101,Drama|Action|Thriller|Romance,2002,36367841,33548272,-2819569
0,The Mothman Prophecies,119,Drama|Mystery|Thriller|Horror,2002,38792364,66865355,28072991
0,Far from Heaven,107,Drama|Romance,2002,16365528,35189419,18823891
0,The Rookie,127,Drama|Family,2002,24245227,91643375,67398148
0,Bad Company,116,Action|Adventure|Comedy|Thriller,2002,84858297,79981727,-4876570
0,Confessions of a Dangerous Mind,113,Comedy|Crime|Drama|Romance|Thriller,2002,36367841,40021361,3653520
0,Ballistic: Ecks vs. Sever,91,Action|Adventure|Thriller,2002,84858297,24153136,-60705161
0,Trapped,106,Action|Crime|Drama|Thriller,2002,36367841,8385053,-27982788
0,Clockstoppers,94,Adventure|Family|Science Fiction|Thriller,2002,31518796,47027599,15508803
0,Halloween: Resurrection,94,Horror|Thriller,2002,15759398,45659649,29900251
0,Salton Sea,103,Drama|Mystery|Thriller,2002,21820705,820334,-21000371
0,Big Fat Liar,88,Comedy|Family,2002,18183920,64213502,46029582
0,Narc,105,Action|Crime|Drama|Thriller,2002,7879699,15315403,7435704
0,Brown Sugar,109,Comedy|Romance,2002,9698091,33170759,23472668
0,Antwone Fisher,120,Drama|Romance,2002,15153267,28327622,13174355
0,Igby Goes Down,97,Comedy|Drama,2002,10910352,5791536,-5118816
0,Swept Away,89,Comedy|Romance,2002,12122613,725714,-11396899
0,Boat Trip,94,Comedy,2002,24245227,10408932,-13836295
0,May,93,Drama|Horror|Thriller|Romance,2002,606130,182175,-423955
0,Crossroads,93,Action|Adventure|Comedy|Drama|Family,2002,14547136,74118910,59571774
0,The Adventures of Pluto Nash,95,Action|Comedy|Science Fiction,2002,121226139,8611872,-112614267
0,Abandon,99,Drama|Mystery|Thriller,2002,30306534,12994662,-17311872
0,Red Dragon,124,Crime|Thriller|Horror,2002,94556388,253600595,159044207
0,Serving Sara,100,Comedy|Romance,2002,35155580,20523809,-14631771
0,Dragonfly,104,Drama,2002,72735683,63428425,-9307258
0,Drumline,118,Drama|Romance|Comedy|Music,2002,24245227,69812297,45567070
0,All About the Benjamins,95,Action|Adventure|Comedy,2002,16971659,30891973,13920314
0,FearDotCom,101,Horror|Thriller,2002,48490455,22914183,-25576272
0,Auto Focus,104,Drama|Crime,2002,8485829,2499763,-5986066
0,The Powerpuff Girls,73,Action|Family,2002,12122613,13833895,1711282
0,Possession,102,Drama|Mystery,2002,30306534,12260488,-18046046
0,Naqoyqatsi,89,Documentary|Drama|Music|Thriller,2002,3636784,16132,-3620652
0,Full Frontal,96,Comedy|Drama|Romance,2002,2424522,3038467,613945
0,Big Trouble,85,Action|Comedy|Thriller,2002,48490455,10296814,-38193641
0,Undercover Brother,86,Action|Comedy,2002,30306534,50435496,20128962
0,Los lunes al sol,113,Drama|Foreign,2002,4849045,177477,-4671568
0,The Kid Stays in the Picture,93,Documentary,2002,48490,1738911,1690421
8,Pulp Fiction,154,Thriller|Crime,1994,11768892,314713075,302944183
7,The Shawshank Redemption,142,Drama|Crime,1994,36777789,41693462,4915673
6,Forrest Gump,142,Comedy|Drama|Romance,1994,80911135,997333314,916422179
4,The Lion King,89,Family|Animation|Drama,1994,66200020,1159591590,1093391570
2,Speed,116,Action|Adventure|Crime|Thriller,1994,44133346,515548317,471414971
2,Dumb and Dumber,107,Comedy,1994,25008896,363769661,338760765
2,The Naked Gun 33â…“: The Final Insult,83,Comedy|Action|Crime,1994,44133346,75221756,31088410
2,Interview with the Vampire,123,Horror|Romance,1994,88266693,329035590,240768897
1,True Lies,141,Action|Thriller,1994,169177829,557378295,388200466
1,The Mask,101,Romance|Comedy|Crime|Fantasy,1994,33835565,517218414,483382849
1,Stargate,121,Action|Adventure|Science Fiction,1994,80911135,289172371,208261236
1,Clear and Present Danger,141,Action|Drama|Thriller,1994,91208916,317594916,226386000
1,Natural Born Killers,119,Crime|Thriller|Drama,1994,50017793,73971558,23953765
1,Clerks,92,Comedy,1994,39720,4635663,4595943
1,Beverly Hills Cop III,104,Action|Comedy|Crime,1994,73555578,175369722,101814144
1,The Santa Clause,97,Fantasy|Drama|Comedy|Family,1994,32364454,279266046,246901592
1,Legends of the Fall,133,Drama|Western|War|Romance,1994,44133346,236317718,192184372
1,Four Weddings and a Funeral,117,Comedy|Drama|Romance,1994,8826669,374693338,365866669
1,The Client,119,Drama|Thriller|Crime|Mystery,1994,66200020,173025096,106825076
0,The Crow,102,Fantasy|Action|Thriller,1994,22066673,138284486,116217813
0,The Flintstones,91,Fantasy|Comedy|Family,1994,67671131,502577619,434906488
0,Star Trek: Generations,118,Science Fiction|Action|Adventure|Thriller,1994,55902239,176533387,120631148
0,Ace Ventura: Pet Detective,86,Comedy|Mystery,1994,22066673,157728750,135662077
0,Disclosure,123,Drama|Thriller|Crime|Mystery|Romance,1994,80911135,314840071,233928936
0,Junior,109,Comedy|Romance|Science Fiction,1994,88266693,54431127,-33835566
0,New Nightmare,112,Horror|Thriller|Mystery|Fantasy,1994,20595561,26612674,6017113
0,The Shadow,108,Adventure|Fantasy|Action|Thriller|Science Fiction,1994,36777789,70706674,33928885
0,Heavenly Creatures,99,Drama|Fantasy,1994,7355557,4485617,-2869940
0,The Swan Princess,90,Fantasy|Animation|Comedy|Family,1994,51488904,14375199,-37113705
0,The Pagemaster,80,Fantasy|Science Fiction|Family|Animation,1994,39720012,20111107,-19608905
0,The Next Karate Kid,107,Adventure,1994,17653338,23283259,5629921
0,Color of Night,121,Thriller|Drama|Romance|Mystery,1994,58844462,29019220,-29825242
0,Ed Wood,127,Comedy|Drama|History,1994,26480008,8661106,-17818902
0,Timecop,99,Thriller|Science Fiction|Action|Crime,1994,39720012,149533460,109813448
0,Wyatt Earp,191,Drama|Action|Western,1994,92680028,36854286,-55825742
0,Terminal Velocity,102,Action|Thriller,1994,73555578,24242300,-49313278
0,Muriel's Wedding,106,Drama|Comedy|Romance,1994,4413334,22242675,17829341
0,Street Fighter,102,Action|Adventure|Thriller,1994,51488904,146263091,94774187
0,The Specialist,110,Action|Thriller,1994,66200020,250622364,184422344
0,Thumbelina,87,Animation|Drama|Family|Fantasy,1994,41191123,16731688,-24459435
0,Highlander III: The Sorcerer,99,Action|Fantasy|Science Fiction,1994,38248900,54136905,15888005
0,On Deadly Ground,102,Action|Thriller,1994,73555578,72084466,-1471112
0,Frankenstein,123,Drama|Horror|Science Fiction|Romance,1994,66200020,164773757,98573737
0,Renaissance Man,128,Comedy|War,1994,58844462,35795563,-23048899
0,A Low Down Dirty Shame,100,Action|Comedy|Crime,1994,14711115,43239525,28528410
0,PrÃªt-Ã -Porter,133,Drama|Comedy,1994,22066673,16624521,-5442152
0,The Chase,89,Comedy|Thriller|Action|Crime,1994,38248900,11782616,-26466284
0,Reality Bites,99,Drama,1994,16917782,29539699,12621917
0,A Troll in Central Park,76,Fantasy|Animation|Science Fiction|Family,1994,33835565,104990,-33730575
0,Hoop Dreams,171,Documentary,1994,1029778,11519702,10489924
0,Double Dragon,89,Action|Adventure|Comedy|Science Fiction,1994,5148890,3444326,-1704564
0,The Ref,97,Comedy,1994,16182227,16828329,646102
0,The Air Up There,107,Comedy|Family,1994,25126585,30910260,5783675
0,Don Juan DeMarco,97,Romance|Drama|Comedy,1994,36777789,32658676,-4119113
0,Leprechaun 2,85,Comedy|Horror,1994,2942223,3325627,383404
0,Baby's Day Out,99,Action|Adventure|Comedy|Family,1994,73555578,24525643,-49029935
0,Texas Chainsaw Massacre: The Next Generation,95,Comedy|Horror|Thriller,1994,882666,273476,-609190
0,Surviving the Game,96,Action|Adventure|Thriller|Crime,1994,10886225,11312867,426642
0,Intersection,98,Drama|Romance,1994,66200020,31416901,-34783119
0,Serial Mom,95,Crime|Comedy|Thriller,1994,19124450,11505104,-7619346
0,Rapa Nui,107,Adventure,1994,29422231,448792,-28973439
0,PCU,79,Comedy,1994,13240004,6400473,-6839531
7,The Avengers,143,Science Fiction|Action|Adventure,2012,208943741,1443191435,1234247694
7,Underworld: Awakening,88,Fantasy|Action|Horror,2012,66482099,125746142,59264043
6,The Dark Knight Rises,165,Action|Crime|Drama|Thriller,2012,237436070,1026712780,789276710
5,Django Unchained,165,Drama|Western,2012,94974428,403991051,309016623
5,Skyfall,143,Action|Adventure|Thriller,2012,189948856,1052849483,862900627
4,The Bourne Legacy,120,Action|Thriller,2012,123466756,262673566,139206810
4,The Hobbit: An Unexpected Journey,169,Adventure|Fantasy|Action,2012,237436070,965893322,728457252
4,Prometheus,124,Science Fiction|Adventure|Mystery,2012,123466756,382908536,259441780
3,Silver Linings Playbook,122,Drama|Comedy|Romance,2012,19944629,195399167,175454538
3,The Amazing Spider-Man,136,Action|Adventure|Fantasy,2012,204195020,714412708,510217688
3,Brave,93,Animation|Adventure|Comedy|Family|Action,2012,175702692,511896218,336193526
3,Snow White and the Huntsman,127,Adventure|Fantasy|Drama,2012,161456527,376668582,215212055
3,21 Jump Street,109,Action|Comedy|Crime,2012,39889259,191454512,151565253
3,Life of Pi,127,Adventure|Drama|Action,2012,113969313,578409999,464440686
3,Ice Age: Continental Drift,88,Animation|Comedy|Adventure|Family,2012,90225706,833158215,742932509
2,Ted,106,Comedy|Fantasy,2012,47487214,521759415,474272201
2,Jack Reacher,130,Crime|Drama|Thriller,2012,56984656,207367731,150383075
2,Lo imposible,113,Drama,2012,39889259,171214317,131325058
2,Wreck-It Ralph,108,Family|Animation|Comedy|Adventure,2012,156707806,447541244,290833438
2,Pitch Perfect,112,Comedy|Music|Romance,2012,16145652,109553407,93407755
2,Men in Black 3,106,Action|Comedy|Science Fiction,2012,213692463,592665861,378973398
2,The Hunger Games,142,Science Fiction|Adventure|Fantasy,2012,71230821,656473401,585242580
2,Total Recall,121,Action|Science Fiction|Adventure|Thriller,2012,118718035,188811132,70093097
2,Cloud Atlas,172,Drama|Science Fiction,2012,96873916,123925357,27051441
2,The Expendables 2,103,Action|Adventure|Thriller,2012,94974428,296864821,201890393
2,Taken 2,91,Action|Thriller|Crime|Drama,2012,42738492,357238054,314499562
2,Dark Shadows,113,Comedy|Fantasy,2012,142461642,233188005,90726363
2,The Perks of Being a Wallflower,102,Drama|Romance,2012,12346675,31721459,19374784
2,Argo,120,Drama|Thriller,2012,42263620,220648512,178384892
1,American Reunion,113,Comedy,2012,47487214,223180013,175692799
1,Magic Mike,110,Drama|Comedy,2012,6648209,158817730,152169521
1,The Cabin in the Woods,95,Horror|Thriller,2012,28492328,63144774,34652446
1,Rise of the Guardians,97,Fantasy|Animation|Family,2012,137712920,291516095,153803175
1,The Vow,104,Drama|Romance,2012,28492328,186258691,157766363
1,Journey 2: The Mysterious Island,94,Adventure|Action|Science Fiction,2012,75029798,337817164,262787366
1,The Paperboy,107,Thriller,2012,11871803,1285828,-10585975
1,Safe,94,Action|Crime|Thriller,2012,28492328,38318559,9826231
1,Abraham Lincoln: Vampire Hunter,94,Action|Horror|Fantasy,2012,65532355,106623173,41090818
1,Upside Down,104,Romance|Science Fiction|Drama|Fantasy,2012,56984656,7699078,-49285578
1,The Lorax,86,Animation|Family,2012,66482099,331309095,264826996
1,Moonrise Kingdom,94,Comedy|Drama|Romance,2012,15195908,64832551,49636643
1,Dredd,95,Action|Science Fiction,2012,47487214,38975360,-8511854
1,Battleship,131,Thriller|Action|Adventure|Science Fiction,2012,198496554,287796721,89300167
1,Les MisÃ©rables,157,Drama|Music|Romance,2012,57934401,419606302,361671901
1,Mirror Mirror,106,Adventure|Fantasy|Drama|Comedy|Science Fiction,2012,80728263,173820794,93092531
1,John Carter,132,Action|Adventure|Fantasy|Science Fiction,2012,246933513,269859485,22925972
1,Looper,118,Action|Thriller|Science Fiction,2012,28492328,44677870,16185542
1,The Twilight Saga: Breaking Dawn - Part 2,115,Adventure|Fantasy|Drama|Romance,2012,113969313,787338009,673368696
1,Zero Dark Thirty,157,Thriller|Drama|History,2012,37989771,126145715,88155944
1,Haywire,93,Thriller,2012,21844118,31695441,9851323
1,Wrath of the Titans,99,Adventure,2012,142461642,285873028,143411386
1,Step Up Revolution,99,Music|Drama|Romance,2012,31341561,133411287,102069726
1,Chronicle,84,Science Fiction|Drama|Thriller,2012,14246164,137712920,123466756
1,Act of Valor,110,Action|Thriller|War,2012,11396931,77188344,65791413
1,Hotel Transylvania,91,Animation|Comedy|Family|Fantasy,2012,80728263,340365179,259636916
1,Sinister,110,Horror|Thriller|Mystery,2012,2849232,73806944,70957712
1,End of Watch,109,Crime|Drama|Thriller,2012,6648209,45707757,39059548
1,Lincoln,149,Drama|War,2012,61733378,261458379,199725001
1,What to Expect When You're Expecting,110,Romance|Comedy|Drama,2012,37989771,75694619,37704848
1,The Dictator,83,Comedy,2012,61733378,170364685,108631307
1,Iron Sky,93,Action|Comedy|Science Fiction,2012,7123082,7726199,603117
1,The Lucky One,101,Drama|Romance,2012,23743607,94363873,70620266
1,Project X,88,Comedy|Crime,2012,11396931,94974428,83577497
1,Contraband,109,Thriller|Action|Drama|Crime,2012,23743607,59928864,36185257
1,Madagascar 3: Europe's Most Wanted,93,Animation|Family,2012,137712920,709384208,571671288
1,Lawless,115,Crime|Drama,2012,24693351,50979024,26285673
1,The Raven,111,Thriller,2012,24693351,28167279,3473928
1,Rock of Ages,123,Comedy|Drama|Music|Romance,2012,71230821,56432487,-14798334
1,Stolen,96,Action|Crime|Drama|Thriller,2012,33241049,2000690,-31240359
1,The Watch,98,Comedy,2012,64582611,64837011,254400
1,The Pirates! In an Adventure with Scientists!,88,Animation|Adventure|Family|Comedy,2012,56984656,112391181,55406525
1,The Master,137,Drama,2012,30391817,26837930,-3553887
1,The Five-Year Engagement,124,Comedy,2012,28492328,51200477,22708149
1,This Is 40,134,Comedy,2012,33241049,83633328,50392279
1,Lockout,95,Action|Thriller|Science Fiction,2012,18994885,30585593,11590708
1,Wanderlust,98,Comedy,2012,33241049,22945759,-10295290
1,The Woman in Black,95,Drama|Horror|Thriller,2012,16145652,121311536,105165884
1,Frankenweenie,87,Animation|Comedy|Family,2012,37040026,77395675,40355649
1,That's My Boy,116,Comedy,2012,66482099,55140602,-11341497
1,Safe House,115,Action|Thriller|Crime|Mystery,2012,80728263,197619185,116890922
0,Savages,131,Crime|Drama|Thriller,2012,42738492,44637981,1899489
0,The Sweeney,112,Action|Drama|Crime,2012,3543021,5977843,2434822
0,Flight,138,Drama,2012,29442072,153642388,124200316
0,Man on a Ledge,102,Action|Thriller|Crime,2012,39889259,43898309,4009050
0,Seven Psychopaths,110,Comedy|Crime|Thriller,2012,14246164,18446181,4200017
0,Big Miracle,107,Adventure|Drama|Romance,2012,37989771,23476933,-14512838
0,Bel Ami,102,Drama,2012,8547698,7885974,-661724
0,Maniac,89,Horror|Crime|Mystery|Thriller,2012,5698465,29519,-5668946
0,Disconnect,115,Drama|Thriller,2012,9497442,3255768,-6241674
0,People Like Us,114,Drama,2012,15195908,11809859,-3386049
0,Piranha 3DD,83,Horror|Thriller|Comedy,2012,4748721,8066869,3318148
0,The Possession,92,Horror|Thriller,2012,13296419,81151921,67855502
0,Silent Hill: Revelation 3D,94,Thriller|Horror|Mystery,2012,18994885,49674281,30679396
0,Killing Them Softly,97,Crime|Thriller,2012,14246164,36024242,21778078
0,The Cold Light of Day,93,Action|Thriller,2012,18994885,16016091,-2978794
0,Arbitrage,100,Drama|Thriller,2012,11396931,33701729,22304798
0,The Iceman,105,Thriller|Crime|Drama,2012,18994885,1870229,-17124656
0,Red Dawn,93,War|Action|Thriller|Science Fiction,2012,61733378,42554985,-19178393
0,Red Lights,119,Thriller,2012,13296419,12870150,-426269
0,The Three Stooges,92,Comedy,2012,28492328,52064317,23571989
0,Hope Springs,100,Drama|Comedy|Romance,2012,28492328,108537774,80045446
0,The Man with the Iron Fists,96,Action,2012,14246164,14824126,577962
0,A Thousand Words,91,Drama|Comedy,2012,37989771,20936426,-17053345
0,To Rome with Love,111,Romance|Comedy,2012,16145652,69563906,53418254
0,About Cherry,102,Drama,2012,2374360,2852,-2371508
0,Alex Cross,101,Action|Thriller|Crime|Mystery,2012,42738492,28827808,-13910684
0,One for the Money,91,Action|Comedy|Thriller|Crime|Romance,2012,37989771,35039600,-2950171
0,Quartet,98,Drama|Comedy|Romance,2012,10447187,56529062,46081875
0,Lay the Favorite,94,Drama|Comedy,2012,25025761,1497449,-23528312
0,ParaNorman,90,Family|Animation|Adventure|Comedy,2012,56984656,101755031,44770375
0,Promised Land,106,Drama,2012,14246164,7729767,-6516397
0,Diary of a Wimpy Kid: Dog Days,94,Comedy|Family,2012,20894374,73236848,52342474
0,For Greater Glory - The True Story of Cristiada,145,Drama,2012,11396931,9139242,-2257689
0,Red Tails,125,Drama|Action|Adventure|History|War,2012,55085168,47834228,-7250940
0,Fun Size,87,Comedy,2012,13296419,10843574,-2452845
0,The Lords of Salem,101,Horror|Thriller,2012,1424616,1107289,-317327
0,Premium Rush,91,Crime|Action|Thriller,2012,33241049,29521470,-3719579
0,Bachelorette,87,Comedy|Romance,2012,2849232,11347500,8498268
0,The Guilt Trip,95,Comedy,2012,37989771,39759834,1770063
0,The Sessions,98,Drama|Romance|Comedy,2012,949744,8679084,7729340
0,Seeking a Friend for the End of the World,101,Drama|Comedy|Romance|Science Fiction,2012,9497442,9152010,-345432
0,The Words,96,Drama|Thriller,2012,5698465,12566504,6868039
0,Paranormal Activity 4,95,Horror,2012,4748721,135640571,130891850
0,Venuto al mondo,127,Drama|Romance|War,2012,12346675,17375,-12329300
0,On the Road,137,Adventure|Drama,2012,23743607,8342855,-15400752
0,Universal Soldier: Day of Reckoning,114,Thriller|Action|Science Fiction|Horror|Mystery,2012,10922059,1331833,-9590226
0,Dracula 3D,109,Horror|Romance|Thriller,2012,5318567,7729,-5310838
0,"For a Good Time, Call...",85,Comedy,2012,807282,1181444,374162
0,Parental Guidance,104,Comedy,2012,23743607,113752992,90009385
0,The Devil Inside,83,Thriller|Horror,2012,949744,96644543,95694799
0,Dark Tide,113,Thriller|Adventure|Drama,2012,23743607,410549,-23333058
0,Think Like a Man,123,Comedy|Romance,2012,11396931,91242414,79845483
0,Hit & Run,100,Action|Comedy|Romance,2012,1899488,13676317,11776829
0,Deadfall,95,Crime|Drama|Thriller,2012,11396931,63016,-11333915
0,ATM,90,Horror|Thriller,2012,2849232,2858,-2846374
0,Beasts of the Southern Wild,93,Drama|Fantasy,2012,1709539,20046961,18337422
0,Fire with Fire,97,Action|Crime|Drama|Thriller,2012,18994885,4403174,-14591711
0,Safety Not Guaranteed,85,Comedy|Romance|Science Fiction|Drama,2012,712308,3806377,3094069
0,The Samaritan,90,Thriller,2012,11396931,2394,-11394537
0,The Apparition,82,Horror|Thriller,2012,16145652,9143655,-7001997
0,2 Days in New York,91,Comedy,2012,7597954,1570679,-6027275
0,Robot & Frank,85,Science Fiction|Comedy|Drama|Crime,2012,2374360,3157935,783575
0,Cosmopolis,109,Drama,2012,19469757,5758827,-13710930
0,Best Man Down,90,Comedy|Drama,2012,1424616,1840,-1422776
0,Joyful Noise,117,Comedy|Music,2012,23,28,5
0,Shadow Dancer,101,Thriller,2012,5983388,398847,-5584541
0,Smashed,85,Drama,2012,474872,357670,-117202
0,Resident Evil: Retribution,95,Action|Horror|Science Fiction,2012,61733378,228089879,166356501
0,Oh Boy,88,Comedy|Drama,2012,284923,2612057,2327134
0,Eega,145,Science Fiction|Romance,2012,5688968,18472526,12783558
0,Sparkle,116,Drama|Music,2012,13296419,23399295,10102876
0,English Vinglish,133,Drama,2012,2697273,11036028,8338755
0,Not Fade Away,112,Drama,2012,18994885,580096,-18414789
0,Redd Inc.,93,Thriller|Horror|Comedy,2012,474872,949744,474872
0,Stitches,86,Horror,2012,94974,90225,-4749
0,Foodfight!,87,Animation|Action|Comedy|Family,2012,61733378,70001,-61663377
0,2016: Obama's America,87,Documentary,2012,2374360,31721459,29347099
0,Katy Perry: Part of Me,93,Documentary|Music,2012,11396931,31082239,19685308
7,The Lord of the Rings: The Return of the King,201,Adventure|Fantasy|Action,2003,111423148,1326278010,1214854862
6,Underworld,121,Fantasy|Action|Thriller,2003,26077758,113448272,87370514
6,Pirates of the Caribbean: The Curse of the Black Pearl,143,Adventure|Fantasy|Action,2003,165949370,776419286,610469916
6,Kill Bill: Vol. 1,111,Action|Crime,2003,35560579,214488375,178927796
4,The Matrix Revolutions,129,Adventure|Action|Thriller|Science Fiction,2003,177802896,503760899,325958003
4,The Matrix Reloaded,138,Adventure|Action|Thriller|Science Fiction,2003,177802896,875501109,697698213
3,Finding Nemo,100,Animation|Family,2003,111423148,1024886690,913463542
2,Bruce Almighty,101,Fantasy|Comedy,2003,94828211,574389691,479561480
2,Love Actually,135,Comedy|Romance|Drama,2003,47414105,290330516,242916411
2,Elf,97,Romance|Comedy|Family|Fantasy,2003,37931284,205538391,167607107
2,Terminator 3: Rise of the Machines,109,Action|Thriller|Science Fiction,2003,237070529,515628400,278557871
2,The Dreamers,115,Drama|Romance,2003,17780289,17923912,143623
2,Big Fish,125,Adventure|Fantasy|Drama,2003,82974685,145702426,62727741
2,Daredevil,103,Fantasy|Action|Crime|Science Fiction|Thriller,2003,92457506,212391152,119933646
2,American Wedding,103,Comedy|Romance,2003,65194395,274348924,209154529
1,The League of Extraordinary Gentlemen,110,Fantasy|Action|Thriller|Science Fiction,2003,92457506,212492483,120034977
1,The Italian Job,111,Thriller|Action|Crime,2003,71121158,208705242,137584084
1,The Jungle Book 2,72,Family|Animation|Adventure,2003,23707052,160828646,137121594
1,Lost in Translation,102,Drama,2003,4741410,141914989,137173579
1,Bad Santa,91,Drama|Comedy|Crime,2003,27263110,90666306,63403196
1,Johnny English,88,Adventure|Action|Comedy,2003,47414105,190347505,142933400
1,Brother Bear,85,Animation|Adventure|Family|Fantasy,2003,118535264,296,-118534968
1,Peter Pan,113,Adventure|Fantasy|Family,2003,118535264,144583401,26048137
1,Scary Movie 3,84,Comedy,2003,56896926,261575581,204678655
1,Honey,94,Music,2003,21336347,74258506,52922159
1,A Man Apart,109,Action|Drama,2003,42672695,52571487,9898792
1,The School of Rock,108,Comedy|Music,2003,41487342,155616590,114129248
1,The Last Samurai,154,Drama|Action|War|History,2003,165949370,541420466,375471096
1,Bad Boys II,147,Adventure|Action|Comedy|Thriller|Crime,2003,154095843,324003765,169907922
1,Lara Croft Tomb Raider: The Cradle of Life,117,Action|Adventure|Fantasy|Thriller,2003,112608501,185514075,72905574
1,Wrong Turn,84,Horror|Thriller,2003,14935443,33961034,19025591
1,Identity,90,Mystery|Thriller,2003,35560579,106989379,71428800
1,Master and Commander: The Far Side of the World,138,Adventure,2003,177802896,251307931,73505035
1,Mystic River,138,Thriller|Crime|Drama|Mystery,2003,29633816,185889396,156255580
1,Anger Management,106,Comedy,2003,88901448,232027829,143126381
1,The Core,136,Action|Thriller|Adventure|Science Fiction,2003,71121158,87962965,16841807
1,Hulk,138,Action|Science Fiction,2003,162393312,290838693,128445381
1,Once Upon a Time in Mexico,102,Action,2003,34375226,116384539,82009313
1,Old School,91,Comedy,2003,28448463,103191288,74742825
1,How to Lose a Guy in 10 Days,116,Comedy|Romance,2003,59267632,210247706,150980074
1,Shanghai Knights,115,Action|Adventure|Comedy|Western,2003,59267632,104694478,45426846
1,S.W.A.T.,117,Action|Thriller|Crime,2003,94828211,138263498,43435287
1,Tears of the Sun,121,Action|Drama|War,2003,82974685,101504660,18529975
1,"Legally Blonde 2: Red, White & Blonde",95,Comedy,2003,53340869,148068138,94727269
1,Freaky Friday,97,Comedy|Family|Fantasy,2003,30819168,130661815,99842647
1,Sinbad: Legend of the Seven Seas,86,Family|Animation|Adventure,2003,71121158,31160929,-39960229
1,Timeline,116,Action|Adventure|Science Fiction,2003,94828211,23091545,-71736666
1,Paycheck,119,Action|Adventure|Mystery|Science Fiction|Thriller,2003,71121158,114113676,42992518
1,Charlie's Angels: Full Throttle,106,Action|Adventure|Comedy|Crime,2003,142242317,307214705,164972388
1,Something's Gotta Give,128,Drama|Comedy|Romance,2003,94828211,316167615,221339404
1,The Haunted Mansion,99,Thriller|Fantasy|Comedy|Family|Mystery,2003,106681738,216078248,109396510
1,Duplex,89,Action|Comedy|Thriller,2003,47414105,22903543,-24510562
0,Gothika,98,Horror|Thriller,2003,47414105,167835650,120421545
0,21 Grams,124,Drama|Crime|Thriller,2003,23707052,71628298,47921246
0,Final Destination 2,90,Horror|Mystery,2003,30819168,107187178,76368010
0,The Texas Chainsaw Massacre,98,Horror,2003,11260850,126917669,115656819
0,Cheaper by the Dozen,98,Comedy|Drama|Family,2003,47414105,225468431,178054326
0,Cold Mountain,154,Drama,2003,93642858,205082020,111439162
0,Thirteen,100,Drama,2003,2370705,5453858,3083153
0,Freddy vs. Jason,97,Horror,2003,35560579,136207485,100646906
0,Cradle 2 the Grave,101,Action|Crime|Drama,2003,29633816,66960046,37326230
0,Looney Tunes: Back in Action,90,Animation|Comedy|Family,2003,94828211,81214251,-13613960
0,Basic,98,Action|Drama|Mystery|Thriller|Crime,2003,59267632,50724275,-8543357
0,The Rundown,104,Adventure|Action|Comedy|Thriller,2003,100754974,95914577,-4840397
0,2 Fast 2 Furious,107,Action|Crime|Thriller,2003,90086801,280158881,190072080
0,Open Range,139,Western,2003,26077758,80955191,54877433
0,Just Married,95,Comedy,2003,21336347,120390264,99053917
0,Daddy Day Care,92,Comedy|Family,2003,71121158,194912119,123790961
0,Seabiscuit,141,Drama|History,2003,103125680,175830997,72705317
0,Out of Time,105,Thriller|Crime|Drama,2003,59267632,65781812,6514180
0,Jeepers Creepers 2,104,Horror|Thriller,2003,20150994,74798912,54647918
0,The Lizzie McGuire Movie,94,Comedy|Adventure|Family,2003,20150994,65827913,45676919
0,Dreamcatcher,136,Drama|Horror|Science Fiction|Thriller,2003,80603979,89749492,9145513
0,Spy Kids 3-D: Game Over,84,Action|Adventure|Comedy|Family|Science Fiction,2003,45043400,233528673,188485273
0,Down with Love,101,Action|Comedy|Romance|Thriller,2003,41487342,24060533,-17426809
0,The Order,102,Drama|Fantasy|Horror|Mystery|Romance,2003,41487342,13703631,-27783711
0,Intolerable Cruelty,100,Crime|Comedy|Romance,2003,71121158,142172162,71051004
0,The Hunted,94,Drama|Action|Thriller|Crime,2003,65194395,40579371,-24615024
0,House of Sand and Fog,126,Drama,2003,19558318,20083186,524868
0,Cabin Fever,93,Horror,2003,1778028,36216546,34438518
0,Runaway Jury,127,Drama|Thriller,2003,71121158,95010921,23889763
0,Monster,110,Crime|Drama,2003,9482821,71569914,62087093
0,In the Cut,119,Thriller|Mystery,2003,14224231,27,-14224204
0,Bringing Down The House,105,Comedy,2003,23707052,157267138,133560086
0,Gigli,121,Drama,2003,64009042,8613020,-55396022
0,Gods and Generals,214,Drama|History|War,2003,66379748,15319421,-51060327
0,Shattered Glass,94,Drama|History,2003,7112115,2,-7112113
0,Dumb and Dumberer: When Harry Met Lloyd,85,Comedy,2003,22521700,46545852,24024152
0,Uptown Girls,92,Comedy,2003,23707052,43971435,20264383
0,Party Monster,98,Comedy|Drama|Crime,2003,5926763,880596,-5046167
0,The Life of David Gale,130,Drama|Thriller|Crime,2003,59267632,46176121,-13091511
0,Elephant,81,Drama|Crime,2003,3556057,11867776,8311719
0,House of the Dead,90,Horror|Action|Thriller,2003,8297468,16379417,8081949
0,Whale Rider,101,Drama|Family,2003,9482821,49073599,39590778
0,House of 1000 Corpses,89,Horror,2003,8297468,19948945,11651477
0,A Guy Thing,101,Comedy|Romance,2003,23707052,20663260,-3043792
0,Radio,109,Drama,2003,37931284,61967255,24035971
0,Young Adam,93,Drama|Thriller|Crime|Romance,2003,7586256,2963381,-4622875
0,Hollywood Homicide,116,Action|Adventure|Comedy|Thriller,2003,88901448,60622086,-28279362
0,Swimming Pool,102,Thriller|Crime,2003,9245750,26600881,17355131
0,A Mighty Wind,91,Comedy|Music,2003,7112115,22225653,15113538
0,Latter Days,107,Drama|Comedy|Romance,2003,1007549,971916,-35633
0,The Station Agent,88,Drama|Comedy,2003,592676,10288640,9695964
0,The Fighting Temptations,122,Comedy|Music|Romance,2003,17780289,35843377,18063088
0,Intermission,105,Romance|Action|Comedy|Crime|Mystery,2003,5926763,5756425,-170338
0,Calendar Girls,108,Comedy,2003,11853526,114436385,102582859
0,Foolproof,97,Action,2003,9786590,546421,-9240169
0,Mambo Italiano,92,Comedy|Romance,2003,5170387,3593753,-1576634
0,Agent Cody Banks,102,Action,2003,33189874,69693773,36503899
0,Biker Boyz,110,Action|Drama,2003,28448463,27868353,-580110
0,Ghosts of the Abyss,92,Family|Documentary,2003,15409584,20199441,4789857
0,Stuck on You,118,Comedy,2003,65194395,40098486,-25095909
0,Kid's Story,15,Science Fiction|Animation,2003,11,5,-6
0,The Company,112,Drama|Thriller,2003,17780289,2704482,-15075807
0,Veronica Guerin,98,Drama|Crime|Thriller,2003,20150994,1860906,-18290088
0,X2,133,Adventure|Action|Science Fiction|Thriller,2003,130388790,254790104,124401314
0,Wonderland,104,Crime|Drama|Mystery|Thriller,2003,5926763,2923605,-3003158
0,Alex & Emma,96,Comedy|Romance,2003,35560579,18217562,-17343017
0,From Justin to Kelly,90,Comedy|Romance,2003,14224231,5834502,-8389729
0,Les Clefs de bagnole,90,Comedy,2003,674722,674722,0
0,Sylvia,109,Drama|Romance,2003,8297468,11853526,3556058
4,Titanic,194,Drama|Romance|Thriller,1997,271692064,2506405735,2234713671
3,Hercules,93,Animation|Family|Fantasy|Adventure|Comedy,1997,115469127,343299361,227830234
3,Men in Black,98,Action|Adventure|Comedy|Science Fiction,1997,122261428,800663660,678402232
3,Gattaca,106,Thriller|Science Fiction|Mystery|Romance,1997,48904571,17025280,-31879291
2,The Fifth Element,126,Adventure|Fantasy|Action|Thriller|Science Fiction,1997,122261428,358525092,236263664
2,Batman & Robin,125,Action|Crime|Fantasy|Science Fiction,1997,169807540,323594923,153787383
2,Tomorrow Never Dies,119,Adventure|Action|Thriller,1997,149430635,452382322,302951687
2,Good Will Hunting,126,Drama,1997,13584603,306921606,293337003
2,Jackie Brown,154,Action|Crime|Drama|Thriller,1997,16301523,53894416,37592893
2,Alien: Resurrection,109,Science Fiction|Horror|Action,1997,95092222,220070572,124978350
2,The Game,129,Drama|Thriller|Mystery,1997,67923016,148647684,80724668
1,Event Horizon,96,Horror|Science Fiction|Mystery,1997,81507619,36234540,-45273079
1,Anastasia,94,Animation|Family,1997,71998397,189918659,117920262
1,Home Alone 3,102,Comedy|Family,1997,43470730,107430458,63959728
1,Austin Powers: International Man of Mystery,94,Science Fiction|Comedy|Crime,1997,22414595,91946013,69531418
1,Starship Troopers,129,Adventure|Action|Thriller|Science Fiction,1997,142638333,164664921,22026588
1,The Full Monty,91,Comedy,1997,4754611,350279159,345524548
1,Con Air,115,Action|Thriller|Crime,1997,101884524,304311731,202427207
1,Face/Off,138,Action|Crime|Science Fiction|Thriller,1997,108676825,333741296,225064471
1,Donnie Brasco,127,Crime|Drama|Thriller,1997,47546111,56994198,9448087
1,I Know What You Did Last Summer,100,Horror|Thriller|Mystery,1997,23093825,170603779,147509954
1,The Devil's Advocate,144,Drama|Horror|Mystery|Thriller,1997,77432238,207769251,130337013
1,Anaconda,89,Adventure|Horror|Thriller,1997,61130714,185953883,124823169
1,Chasing Amy,113,Comedy|Drama|Romance,1997,339615,16330421,15990806
1,Dante's Peak,108,Action|Adventure|Thriller,1997,157581397,241979494,84398097
1,Speed 2: Cruise Control,121,Action|Adventure|Thriller,1997,217353651,223477680,6124029
1,L.A. Confidential,138,Crime|Drama|Mystery|Thriller,1997,47546111,171460704,123914593
1,Scream 2,120,Horror|Mystery,1997,32603047,234148705,201545658
1,Liar Liar,86,Comedy,1997,61130714,245881318,184750604
1,Contact,150,Drama|Science Fiction|Mystery,1997,122261428,232460177,110198749
1,Lolita,137,Drama|Romance,1997,84224539,1440044,-82784495
1,The Rainmaker,135,Drama|Crime|Thriller,1997,54338412,62376108,8037696
0,The Jackal,124,Action|Thriller|Adventure|Crime,1997,81507619,216443863,134936244
0,Flubber,93,Comedy|Family|Science Fiction,1997,108676825,241774999,133098174
0,The Saint,116,Thriller|Action|Romance|Science Fiction|Adventure,1997,92375301,160384313,68009012
0,Conspiracy Theory,135,Action|Drama|Mystery|Thriller,1997,101884524,186085744,84201220
0,Air Force One,124,Action|Thriller,1997,115469127,428127476,312658349
0,Wag the Dog,97,Comedy|Drama,1997,20376904,87289923,66913019
0,As Good as It Gets,139,Comedy|Romance,1997,67923016,426798361,358875345
0,Breakdown,95,Drama|Action|Thriller,1997,48904571,68139206,19234635
0,Seven Years in Tibet,136,History|Drama|Adventure|War,1997,95092222,178580044,83487822
0,My Best Friend's Wedding,105,Comedy|Romance,1997,51621492,406571694,354950202
0,Boogie Nights,155,Drama,1997,20376904,58551805,38174901
0,Lost Highway,134,Drama|Thriller|Mystery,1997,20376904,4992614,-15384290
0,Mad City,114,Action|Drama|Thriller,1997,67923016,14320240,-53602776
0,Bean,85,Comedy,1997,24452285,341262444,316810159
0,The Devil's Own,107,Crime|Thriller|Drama,1997,122261428,191281465,69020037
0,Kiss the Girls,115,Drama|Mystery|Thriller|Crime,1997,36678428,82224713,45546285
0,Absolute Power,121,Crime|Drama|Thriller,1997,67923016,68015812,92796
0,Vegas Vacation,93,Comedy,1997,33961508,49448444,15486936
0,U Turn,125,Thriller,1997,25810746,9077364,-16733382
0,Mimic,105,Fantasy|Horror|Thriller,1997,40753809,34614234,-6139575
0,One Eight Seven,119,Drama|Thriller,1997,27169206,7765067,-19404139
0,Spawn,96,Action|Adventure|Fantasy|Horror|Science Fiction,1997,54338412,119327211,64988799
0,Cube,90,Thriller|Science Fiction|Mystery,1997,339615,681699,342084
0,Kundun,134,Drama,1997,38036888,7722560,-30314328
0,The Postman,177,Drama|Adventure,1997,108676825,23944539,-84732286
0,G.I. Jane,125,Action|Drama,1997,67923016,65435887,-2487129
0,The Relic,110,Horror|Thriller|Mystery,1997,81507619,46128704,-35378915
0,Fire Down Below,105,Action|Adventure|Crime|Thriller,1997,81507619,21735365,-59772254
0,MouseHunt,98,Comedy|Family,1997,51621492,166299165,114677673
0,The Sweet Hereafter,112,Drama,1997,6792301,4433450,-2358851
0,Cop Land,104,Action|Crime|Drama,1997,20376904,60943500,40566596
0,Selena,127,Documentary|Drama,1997,27169206,81507619,54338413
0,Spice World - The Movie,93,Adventure|Fantasy|Drama|Comedy|Music,1997,33961508,135846032,101884524
0,The Ice Storm,112,Drama,1997,24452285,10919386,-13532899
0,Air Bud,98,Comedy|Family|Drama,1997,4075380,31440883,27365503
0,Cats Don't Dance,75,Animation|Comedy|Family|Music,1997,43470730,4845134,-38625596
1,Mortal Kombat: Annihilation,95,Action|Fantasy|Science Fiction,1997,40753809,69793427,29039618
0,Metro,117,Action|Adventure|Comedy|Crime|Thriller,1997,74715317,43453835,-31261482
0,Wishmaster,90,Horror,1997,6792301,21380493,14588192
0,For Richer or Poorer,115,Comedy,1997,47546111,42942594,-4603517
0,Turbo: A Power Rangers Movie,99,Action|Adventure|Family|Fantasy|Science Fiction,1997,13584603,24424762,10840159
0,The Man Who Knew Too Little,97,Comedy|Thriller|Crime|Action,1997,27169206,18749136,-8420070
0,Turbulence,100,Action|Thriller|Crime,1997,74715317,15576225,-59139092
0,Steel,97,Science Fiction|Action|Adventure,1997,21735365,2290946,-19444419
0,Private Parts,109,Comedy|Drama,1997,38036888,56010404,17973516
0,Playing God,94,Drama|Action|Thriller|Crime,1997,16301523,5433841,-10867682
0,Picture Perfect,105,Comedy|Romance,1997,25810746,60223283,34412537
0,Anna Karenina,108,Drama|Romance,1997,47546111,1075669,-46470442
0,Most Wanted,99,Action|Thriller,1997,33961508,16081749,-17879759
0,Midnight in the Garden of Good and Evil,155,Crime|Drama|Mystery|Thriller,1997,47546111,34104492,-13441619
0,An American Werewolf in Paris,105,Horror|Comedy,1997,29886127,36094919,6208792
0,Amistad,155,Drama|History|Mystery,1997,48904571,100526063,51621492
0,Affliction,114,Drama,1997,8150761,8599127,448366
0,Rosewood,140,Drama|History,1997,40753809,17837058,-22916751
0,The Lost World: Jurassic Park,129,Adventure|Action|Science Fiction,1997,99167603,311188651,212021048
0,Switchback,118,Action|Adventure|Mystery|Thriller,1997,50263031,8805804,-41457227
0,La vÃ©ritÃ© si je mens !,100,Comedy,1997,5433841,40014807,34580966
0,The Castle,85,Drama|Comedy,1997,1068666,1170706,102040
6,Frozen,102,Animation|Adventure|Family,2013,140405002,1192711491,1052306489
5,Gravity,91,Science Fiction|Thriller|Drama,2013,98283502,670567465,572283963
5,Thor: The Dark World,112,Action|Adventure|Fantasy,2013,159125670,449076041,289950371
4,Iron Man 3,130,Action|Adventure|Science Fiction,2013,187206670,1137692373,950485703
4,Now You See Me,115,Thriller|Crime,2013,70202501,110170090,39967589
4,The Hunger Games: Catching Fire,146,Science Fiction|Thriller|Action|Adventure,2013,121684335,793216615,671532280
4,The Wolf of Wall Street,180,Crime|Drama|Comedy,2013,93603335,366925723,273322388
4,Pacific Rim,131,Action|Science Fiction|Adventure,2013,168486003,381529914,213043911
4,Oblivion,126,Action|Science Fiction|Adventure|Mystery,2013,112324002,267863327,155539325
4,The Hobbit: The Desolation of Smaug,161,Adventure|Fantasy,2013,234008338,897094365,663086027
3,Man of Steel,143,Action|Adventure|Fantasy|Science Fiction,2013,210607504,620445512,409838008
3,Her,126,Romance|Science Fiction|Drama,2013,21528767,44322350,22793583
3,Despicable Me 2,98,Animation|Comedy|Family,2013,71138534,908665501,837526967
3,Star Trek Into Darkness,132,Action|Adventure|Science Fiction,2013,177846337,437469458,259623121
3,12 Years a Slave,134,Drama|History,2013,18720667,175038237,156317570
3,Riddick,119,Science Fiction|Action|Thriller,2013,35569267,92046987,56477720
3,The Conjuring,112,Horror|Thriller,2013,12168433,297658738,285490305
3,The Great Gatsby,143,Drama|Romance,2013,98283502,328585540,230302038
2,Elysium,109,Science Fiction|Action|Drama|Thriller,2013,107643835,267837238,160193403
2,A Good Day to Die Hard,98,Action|Thriller,2013,86115068,285166475,199051407
2,The Purge,86,Science Fiction|Horror|Thriller,2013,2808100,83614574,80806474
2,Monsters University,104,Animation|Family,2013,187206670,695996591,508789921
2,World War Z,116,Action|Drama|Horror|Science Fiction|Thriller,2013,187206670,497843379,310636709
2,The Secret Life of Walter Mitty,114,Adventure|Comedy|Drama|Fantasy,2013,84243001,176099064,91856063
2,Ender's Game,114,Science Fiction|Action|Adventure,2013,102963668,117506997,14543329
2,We're the Millers,110,Comedy|Crime,2013,34633234,252723500,218090266
2,2 Guns,109,Action|Crime|Drama|Comedy|Thriller,2013,57098034,123500625,66402591
2,Rush,123,Drama|Action,2013,35569267,84474786,48905519
2,G.I. Joe: Retaliation,110,Adventure|Action|Science Fiction|Thriller,2013,121684335,348088599,226404264
2,Inside Llewyn Davis,105,Drama|Music,2013,10296366,30828557,20532191
2,Olympus Has Fallen,120,Action|Thriller,2013,65522334,150725369,85203035
2,Percy Jackson: Sea of Monsters,106,Adventure|Family|Fantasy,2013,84243001,163411533,79168532
2,Prisoners,153,Drama|Thriller|Crime,2013,43057534,114314652,71257118
2,American Hustle,138,Drama|Crime,2013,37441334,235105188,197663854
1,Warm Bodies,97,Horror|Comedy|Romance,2013,32761167,109497801,76736634
1,Hansel & Gretel: Witch Hunters,88,Fantasy|Horror|Action,2013,46801667,210423550,163621883
1,47 Ronin,118,Action|Adventure|Fantasy,2013,163805836,141305911,-22499925
1,The Mortal Instruments: City of Bones,130,Action|Adventure|Drama|Mystery|Romance,2013,56162001,84772254,28610253
1,Epic,102,Animation|Adventure|Family|Fantasy,2013,93603335,251256282,157652947
1,Lone Survivor,121,Action|Drama|Thriller|War,2013,37441334,139745662,102304328
1,Dallas Buyers Club,117,Drama|History,2013,4680166,51667435,46987269
1,R.I.P.D.,96,Fantasy|Action|Comedy|Crime,2013,121684335,57705052,-63979283
1,Planes,91,Animation|Family|Adventure|Comedy,2013,46801667,205729565,158927898
1,Spring Breakers,94,Drama|Crime,2013,4680166,29694987,25014821
1,The Call,94,Thriller,2013,12168433,64186032,52017599
1,Evil Dead,91,Horror,2013,15912567,91303456,75390889
1,Last Vegas,105,Comedy,2013,26208933,125805175,99596242
1,The Family,111,Crime|Comedy|Action,2013,28081000,34534225,6453225
1,The Place Beyond the Pines,140,Drama|Crime,2013,14040500,33215712,19175212
1,Grown Ups 2,100,Comedy,2013,74882668,231185521,156302853
1,The Hangover Part III,100,Comedy,2013,96411435,338844141,242432706
1,The Croods,98,Adventure|Animation|Comedy|Family|Fantasy,2013,126364502,547746993,421382491
1,Homefront,100,Action|Thriller,2013,20592733,40304564,19711831
1,Escape Plan,115,Action|Thriller,2013,46801667,115052643,68250976
1,Carrie,100,Drama|Horror,2013,28081000,77123801,49042801
1,Captain Phillips,134,Action|Drama|Thriller,2013,51481834,88923168,37441334
1,The Counselor,117,Thriller|Crime|Drama,2013,23400833,66467104,43066271
1,White House Down,131,Action|Drama|Thriller,2013,140405002,192230115,51825113
1,Begin Again,104,Comedy|Music|Romance|Drama,2013,7488266,59405226,51916960
1,The Big Wedding,90,Comedy,2013,32761167,20423637,-12337530
1,Life of Crime,94,Comedy|Crime,2013,11232400,1363496,-9868904
1,Jack the Giant Slayer,114,Action|Family|Fantasy,2013,182526503,185042189,2515686
1,Runner Runner,91,Crime|Thriller|Drama,2013,28081000,58611269,30530269
1,Bullet to the Head,92,Action|Crime|Thriller,2013,51481834,8882796,-42599038
1,What If,93,Drama|Comedy|Romance,2013,10296366,7345053,-2951313
1,Delivery Man,105,Comedy,2013,24336867,47891309,23554442
1,This Is the End,107,Action|Comedy,2013,29953067,117978881,88025814
1,Jackass Presents: Bad Grandpa,92,Comedy,2013,14040500,142119382,128078882
1,Parker,118,Action|Crime,2013,32761167,43260317,10499150
1,After Earth,100,Science Fiction|Action|Adventure,2013,121684335,228245299,106560964
1,The Heat,117,Action|Comedy|Crime,2013,40249434,148524324,108274890
1,Saving Mr. Banks,125,Comedy|Drama|History,2013,32761167,105345480,72584313
1,Kick-Ass 2,103,Action|Adventure|Crime,2013,26208933,27144967,936034
1,Oculus,104,Horror,2013,4680166,41213778,36533612
1,The Lone Ranger,149,Action|Adventure|Western,2013,238688504,83578333,-155110171
1,Gangster Squad,113,Crime|Drama|Action|Thriller,2013,56162001,98471553,42309552
1,Identity Thief,111,Comedy|Crime,2013,32761167,162837051,130075884
1,Stoker,99,Drama|Horror|Thriller,2013,11232400,11304887,72487
1,All Is Lost,106,Action|Adventure|Drama,2013,8424300,5717965,-2706335
1,Texas Chainsaw 3D,92,Horror|Thriller,2013,18720667,44220036,25499369
1,The Spectacular Now,95,Comedy|Drama|Romance,2013,2340083,6416144,4076061
1,Trance,101,Thriller|Crime|Drama|Mystery,2013,18720667,22709637,3988970
1,Anchorman 2: The Legend Continues,119,Comedy,2013,46801667,162541269,115739602
1,Oz: The Great and Powerful,130,Fantasy|Adventure|Family,2013,187206670,460405366,273198696
1,Turbo,96,Animation|Family,2013,126364502,264495582,138131080
1,Redemption,100,Action|Thriller,2013,18720667,7818578,-10902089
1,Pain & Gain,130,Thriller|Crime|Action,2013,23400833,80662946,57262113
1,The Host,125,Action|Adventure|Romance|Science Fiction|Thriller,2013,41185467,59276372,18090905
1,Oldboy,104,Drama|Thriller|Mystery|Action,2013,28081000,4550078,-23530922
1,Labor Day,111,Drama,2013,16848600,18978836,2130236
1,Mama,100,Horror,2013,14040500,137126799,123086299
1,The Physician,155,Adventure|Drama|History,2013,29953067,53619956,23666889
1,Admission,107,Comedy|Drama|Romance,2013,12168433,16848600,4680167
1,The Butler,132,Drama,2013,23400833,108507022,85106189
1,Movie 43,90,Comedy,2013,5616200,30363974,24747774
1,21 & Over,93,Comedy,2013,12168433,44991072,32822639
1,Escape from Planet Earth,89,Animation|Comedy|Adventure|Family|Science Fiction,2013,37441334,69825881,32384547
0,Grudge Match,113,Comedy,2013,37441334,42034693,4593359
0,Belle,105,Drama,2013,10202763,15449661,5246898
0,Machete Kills,107,Action|Crime|Thriller,2013,11232400,14048139,2815739
0,Safe Haven,115,Romance,2013,26208933,91351370,65142437
0,Bad Words,88,Comedy,2013,8892316,7301060,-1591256
0,The Bling Ring,90,Drama|Crime,2013,14040500,17921043,3880543
0,Empire State,94,Action|Drama,2013,10296366,3406548,-6889818
0,Behind the Candelabra,118,Drama|Romance,2013,21528767,14602120,-6926647
0,Cloudy with a Chance of Meatballs 2,95,Animation|Family|Comedy,2013,73010601,232496289,159485688
0,Blue Jasmine,98,Comedy|Drama,2013,16848600,91268382,74419782
0,Third Person,137,Drama|Romance,2013,26208933,956062,-25252871
0,A Haunted House,86,Comedy|Horror,2013,2340083,56294621,53954538
0,Only God Forgives,90,Drama|Thriller|Crime,2013,4492960,9676139,5183179
0,Side Effects,106,Thriller|Crime|Drama,2013,28081000,59319014,31238014
0,La migliore offerta,124,Drama|Romance|Crime|Mystery,2013,12636450,18024139,5387689
0,The Incredible Burt Wonderstone,100,Comedy,2013,28081000,25682771,-2398229
0,Mud,130,Drama,2013,9360333,20206807,10846474
0,Adore,100,Drama,2013,14976533,298577,-14677956
0,The Railway Man,116,Drama|History,2013,16848600,20882176,4033576
0,Broken City,109,Thriller|Crime|Drama,2013,52417867,18440946,-33976921
0,Walking With Dinosaurs,87,Animation|Family|Adventure,2013,74882668,118451761,43569093
0,No One Lives,86,Horror|Thriller,2013,2714496,70125,-2644371
0,Welcome to the Punch,99,Action|Adventure|Crime,2013,7956283,9123,-7947160
0,Beautiful Creatures,124,Fantasy|Drama|Romance,2013,56162001,56210804,48803
0,The Frozen Ground,105,Thriller|Crime,2013,25478827,5145329,-20333498
0,The Smurfs 2,105,Fantasy|Family|Comedy|Animation,2013,98283502,325209978,226926476
0,The Immigrant,120,Drama|Romance,2013,14976533,5492349,-9484184
0,42,128,Drama,2013,37441334,88942088,51500754
0,Lovelace,92,Drama,2013,9360333,1484157,-7876176
0,The Way Way Back,103,Comedy|Drama,2013,4305753,21714712,17408959
0,The Fifth Estate,128,Drama|Thriller,2013,26208933,8007772,-18201161
0,The Adventurer: The Curse of the Midas Box,99,Fantasy|Adventure|Family,2013,23400833,5989,-23394844
0,Blood Ties,128,Thriller|Crime|Drama,2013,23868850,2260962,-21607888
0,The Wolverine,126,Action|Science Fiction|Adventure|Fantasy,2013,112324002,388866326,276542324
0,Snitch,112,Thriller|Drama,2013,32761167,40184344,7423177
0,Free Birds,91,Animation|Comedy|Family,2013,51481834,102963668,51481834
0,Nebraska,115,Drama|Adventure,2013,11232400,16525586,5293186
0,Scary Movie 5,86,Comedy,2013,18720667,73365118,54644451
0,Man of Tai Chi,105,Action|Drama,2013,23400833,1923493,-21477340
0,Baggage Claim,96,Comedy,2013,7956283,21020041,13063758
0,August: Osage County,121,Comedy|Drama,2013,23400833,69443319,46042486
0,Before Midnight,108,Romance|Drama,2013,2808100,10461547,7653447
0,Paranormal Activity: The Marked Ones,84,Horror|Thriller,2013,4680166,80838060,76157894
0,Jobs,128,Drama|History,2013,11232400,33632998,22400598
0,Dark Skies,97,Science Fiction|Thriller|Horror,2013,3276116,23563999,20287883
0,In a World...,93,Comedy,2013,936033,2774311,1838278
0,Paranoia,106,Drama|Thriller,2013,32761167,12903233,-19857934
0,Repentance,90,Horror|Thriller,2013,4680166,1113516,-3566650
0,Out of the Furnace,116,Thriller|Drama|Crime,2013,20592733,14414913,-6177820
0,The To Do List,104,Comedy|Romance,2013,1404050,3338105,1934055
0,Fast & Furious 6,130,Action|Thriller|Crime,2013,149765336,738230644,588465308
0,Battle of the Year,110,Music|Drama,2013,18720667,15490862,-3229805
0,Upstream Color,96,Drama|Science Fiction,2013,93603,415690,322087
0,Khumba,85,Animation|Adventure|Family,2013,18720667,25448289,6727622
0,Jimmy P.,117,Drama,2013,9360333,28345,-9331988
0,Black Nativity,93,Drama|Music,2013,16380583,6569258,-9811325
0,The Sacrament,99,Mystery|Horror|Thriller,2013,3744133,8631,-3735502
0,Sweetwater,95,Western|Thriller,2013,6552233,5753,-6546480
0,Phantom,99,Thriller,2013,9360333,968409,-8391924
0,Wolf Creek 2,106,Horror|Thriller,2013,7488266,9014416,1526150
0,Metallica: Through the Never,93,Music,2013,16848600,7462963,-9385637
0,Legends of Oz: Dorothy's Return,88,Animation|Music|Family,2013,65522334,17468279,-48054055
0,Austenland,97,Comedy|Romance,2013,4586563,2020934,-2565629
0,The East,116,Drama|Thriller,2013,6084216,2247893,-3836323
0,The Best Man Holiday,123,Comedy,2013,15912567,67043571,51131004
0,The Young and Prodigious T.S. Spivet,105,Adventure|Drama|Family,2013,30889100,8887439,-22001661
0,The Canyons,99,Thriller|Drama,2013,234008,53190,-180818
0,Make Your Move,110,Music,2013,14,114,100
0,The Face of Love,92,Drama|Romance,2013,3744133,327617,-3416516
0,Parkland,94,History|Drama|Thriller|Mystery,2013,9360333,611839,-8748494
0,The Last Exorcism Part II,88,Horror|Thriller,2013,4680166,14208332,9528166
0,What Maisie Knew,93,Drama,2013,5616200,998252,-4617948
0,Mandela: Long Walk to Freedom,141,Drama|History,2013,32761167,25581791,-7179376
0,Philomena,98,Drama,2013,11232400,93724899,82492499
0,Hross Ã­ oss,85,Drama|Romance|Comedy,2013,9,10,1
0,Diana,113,Drama|Romance,2013,14040500,20373955,6333455
0,Gimme Shelter,101,Drama,2013,7020250,1272921,-5747329
0,Getaway,90,Action|Crime,2013,16848600,9830164,-7018436
0,On the Job,120,Action|Crime,2013,985411,436273,-549138
0,Nothing Left to Fear,100,Horror,2013,2808100,1568212,-1239888
0,Home Run,114,Drama,2013,1123240,2678010,1554770
0,The Internship,119,Comedy,2013,54289934,41185467,-13104467
0,Ð¡Ñ‚Ð°Ð»Ð¸Ð½Ð³Ñ€Ð°Ð´,131,War|Action,2013,28081000,63771501,35690501
6,Back to the Future,116,Adventure|Comedy|Science Fiction|Family,1985,38516154,772572771,734056617
2,The Breakfast Club,97,Comedy|Drama,1985,2027166,104450077,102422911
1,Ladyhawke,121,Adventure|Fantasy,1985,40543321,37364724,-3178597
1,Mad Max Beyond Thunderdome,107,Action|Adventure|Drama|Science Fiction,1985,24945338,73444670,48499332
1,A View to a Kill,131,Adventure|Action|Thriller,1985,60814981,308996785,248181804
1,Legend,114,Action|Adventure|Fantasy|Romance,1985,50679151,31425355,-19253796
1,The Goonies,114,Adventure|Comedy|Family,1985,38516154,124447075,85930921
1,A Nightmare on Elm Street Part 2: Freddy's Revenge,87,Horror,1985,6081498,60813386,54731888
1,Rambo: First Blood Part II,96,Action|Adventure|Drama|Thriller|War,1985,89195306,608961557,519766251
1,Out of Africa,161,Drama,1985,62842147,260489226,197647079
1,Rocky IV,91,Drama,1985,62842147,609110116,546267969
1,The Black Cauldron,80,Animation,1985,50679151,43155713,-7523438
1,The Color Purple,154,Drama,1985,30407490,296558194,266150704
0,Commando,90,Action|Adventure|Thriller,1985,20271660,116562048,96290388
0,King Solomon's Mines,100,Action|Adventure|Comedy,1985,25339575,482925,-24856650
0,The Return of the Living Dead,91,Comedy|Horror,1985,8108664,28860763,20752099
0,Witness,113,Crime|Drama|Romance|Thriller,1985,24325992,139280483,114954491
0,Fright Night,106,Horror|Thriller|Comedy,1985,18244494,50521512,32277018
0,Red Sonja,89,Adventure|Fantasy|Action,1985,36286272,14086032,-22200240
0,Day of the Dead,102,Horror|Science Fiction,1985,7095081,68923645,61828564
0,Clue: The Movie,94,Comedy|Thriller|Crime|Mystery,1985,30407490,29685813,-721677
0,Friday the 13th: A New Beginning,92,Horror|Thriller,1985,4459765,44456598,39996833
0,Santa Claus: The Movie,108,Adventure|Comedy|Fantasy|Science Fiction|Family,1985,101358302,48078887,-53279415
0,The Purple Rose of Cairo,82,Fantasy|Comedy|Romance,1985,30407490,21551477,-8856013
0,The Jewel of the Nile,106,Action|Adventure|Comedy|Romance,1985,50679151,196175345,145496194
0,Re-Animator,86,Science Fiction|Comedy|Horror,1985,1824449,4101796,2277347
0,Porky's Revenge,92,Comedy,1985,18244494,41595227,23350733
0,After Hours,97,Comedy|Thriller|Drama,1985,9122247,21506855,12384608
0,Pee-wee's Big Adventure,90,Adventure|Comedy|Family,1985,12162996,82993520,70830524
0,Brewster's Millions,97,Comedy,1985,40543321,92911369,52368048
0,Desperately Seeking Susan,104,Drama|Action|Comedy|Romance,1985,10135830,55544349,45408519
0,Runaway Train,111,Action|Thriller,1985,18244494,16087614,-2156880
0,Return to Oz,113,Adventure|Fantasy|Science Fiction|Family,1985,50679151,22578172,-28100979
0,Mishima: A Life in Four Chapters,121,Drama,1985,10135830,1019173,-9116657
0,Once Bitten,94,Horror|Comedy|Romance,1985,6486931,20271660,13784729
0,The Last Dragon,108,Action|Adventure|Comedy|Drama,1985,20271660,52208210,31936550
0,Explorers,109,Adventure|Family|Fantasy|Romance|Science Fiction,1985,50679151,20014299,-30664852
0,Perfect,115,Drama|Romance,1985,38516154,26188670,-12327484
0,Into the Night,115,Comedy|Drama|Thriller,1985,231,13582012,13581781
0,My Beautiful Laundrette,97,Drama,1985,1743362,4969688,3226326
0,Missing in Action 2: The Beginning,100,Action|Adventure|War,1985,4885470,21803077,16917607
5,Harry Potter and the Goblet of Fire,157,Adventure|Fantasy|Family,2005,167484493,1000352539,832868046
5,Batman Begins,140,Action|Crime|Drama,2005,167484493,417838832,250354339
3,"The Chronicles of Narnia: The Lion, the Witch and the Wardrobe",143,Adventure|Family|Fantasy,2005,200981392,836090359,635108967
3,V for Vendetta,132,Action|Thriller|Fantasy,2005,60294417,147956957,87662540
3,Sin City,124,Action|Thriller|Crime,2005,44662531,177236356,132573825
3,Charlie and the Chocolate Factory,115,Adventure|Comedy|Family|Fantasy,2005,167484493,530332684,362848191
3,Star Wars: Episode III - Revenge of the Sith,140,Science Fiction|Adventure|Action,2005,126171651,949078796,822907145
3,The Hitchhiker's Guide to the Galaxy,109,Adventure|Comedy|Family|Science Fiction,2005,55828164,116656763,60828599
2,The Island,136,Action|Thriller|Science Fiction|Adventure,2005,140686974,181943054,41256080
2,Madagascar,86,Family|Animation,2005,83742246,594771682,511029436
2,Fantastic Four,106,Action|Adventure|Fantasy|Science Fiction,2005,111656329,369113178,257456849
2,Constantine,121,Drama|Fantasy|Horror,2005,111656329,257286597,145630268
2,Wedding Crashers,119,Comedy|Romance,2005,44662531,318417880,273755349
2,Ã†on Flux,93,Action|Science Fiction,2005,69226923,58400727,-10826196
2,The Pacifier,95,Action|Comedy|Drama|Family|Thriller,2005,62527544,126179333,63651789
1,War of the Worlds,116,Adventure|Thriller|Science Fiction,2005,147386354,660714467,513328113
1,Memoirs of a Geisha,145,Drama|History|Romance,2005,94907879,181154535,86246656
1,The 40 Year Old Virgin,116,Comedy|Romance,2005,29030645,122207000,93176355
1,Chicken Little,81,Animation|Family|Comedy,2005,167484493,351083970,183599477
1,Hitch,118,Comedy|Drama|Romance,2005,78159430,411007415,332847985
1,Transporter 2,87,Action|Thriller|Crime,2005,35730025,95095059,59365034
1,Nanny McPhee,97,Fantasy|Comedy|Family,2005,27914082,136767638,108853556
1,Kingdom of Heaven,144,Drama|Action|Adventure|History|War,2005,145153227,236312980,91159753
1,Monster-in-Law,101,Comedy,2005,48012221,172788077,124775856
1,King Kong,187,Adventure|Drama|Action,2005,231128601,614109809,382981208
1,Be Cool,118,Comedy|Crime,2005,59177854,106325985,47148131
1,Into the Blue,110,Action|Thriller|Adventure|Crime,2005,55828164,49613863,-6214301
1,Pride & Prejudice,128,Drama|Romance,2005,31263772,135269350,104005578
1,Brokeback Mountain,134,Drama|Romance,2005,15631886,198797127,183165241
1,Robots,91,Animation|Comedy|Family|Science Fiction,2005,83742246,291084693,207342447
1,xXx: State of the Union,101,Action|Crime|Adventure,2005,97141006,79358543,-17782463
1,The Sisterhood of the Traveling Pants,119,Drama|Comedy,2005,27914082,43605214,15691132
1,Mr. & Mrs. Smith,120,Action|Comedy|Drama|Thriller,2005,122821961,533948961,411127000
1,The Legend of Zorro,129,Action|Adventure|Drama|Western,2005,83742246,158998685,75256439
1,Lord of War,122,Crime|Drama|Thriller,2005,46895658,26940321,-19955337
1,Zathura: A Space Adventure,101,Family|Fantasy|Science Fiction|Adventure,2005,72576613,71819026,-757587
1,Elektra,97,Action,2005,48012221,63288555,15276334
1,Corpse Bride,77,Romance|Fantasy|Animation|Music,2005,44662531,130855702,86193171
1,The Curse of the Were-Rabbit,85,Adventure|Animation|Comedy|Family,2005,33496898,214885767,181388869
1,Rumor Has It...,97,Comedy,2005,78159430,99299950,21140520
1,The Jacket,103,Drama|Mystery|Thriller|Fantasy,2005,32380335,23588767,-8791568
1,Jarhead,125,Drama|War,2005,80392556,108183814,27791258
1,Serenity,119,Science Fiction|Action|Adventure|Thriller,2005,43545968,43400216,-145752
1,Saw II,92,Horror,2005,4466253,170750544,166284291
1,Just Like Heaven,95,Comedy|Fantasy|Romance,2005,64760670,114843481,50082811
1,Herbie Fully Loaded,101,Comedy|Family|Adventure|Fantasy|Romance,2005,55828164,73695414,17867250
1,Elizabethtown,123,Comedy|Drama|Romance,2005,63644107,58100246,-5543861
1,Four Brothers,109,Action|Crime,2005,50245348,103142169,52896821
1,Hostel,94,Horror,2005,5359503,89971479,84611976
1,Kiss Kiss Bang Bang,103,Action|Comedy|Crime|Mystery,2005,16748449,17625116,876667
1,Cinderella Man,144,Romance|Drama|History,2005,98257569,121191680,22934111
1,Match Point,124,Drama|Thriller|Crime|Romance,2005,16748449,95249965,78501516
1,Hoodwinked!,80,Animation|Comedy|Family,2005,16748449,57004784,40256335
1,Hide and Seek,101,Horror|Mystery|Thriller,2005,27914082,136940703,109026621
1,Bewitched,102,Comedy|Fantasy|Romance,2005,94907879,146745635,51837756
1,Doom,100,Action|Adventure|Science Fiction|Thriller|Horror,2005,66993797,62513387,-4480410
0,Cheaper by the Dozen 2,94,Adventure|Comedy|Family,2005,66993797,144239689,77245892
0,Fever Pitch,103,Comedy|Drama|Romance,2005,33496898,56332077,22835179
0,Must Love Dogs,98,Comedy|Romance,2005,33496898,65213228,31716330
0,Proof,100,Drama|Mystery,2005,22331265,8413673,-13917592
0,The Interpreter,128,Action,2005,89325063,181938319,92613256
0,The Brothers Grimm,118,Adventure|Fantasy|Action|Comedy|Thriller,2005,98257569,117592277,19334708
0,An Unfinished Life,108,Drama,2005,33496898,20788492,-12708406
0,Hostage,113,Mystery|Drama|Thriller|Crime,2005,58061291,87030218,28968927
0,The Dukes of Hazzard,104,Action|Adventure|Comedy,2005,55828164,123719317,67891153
0,Munich,164,Drama|Action|History|Thriller,2005,78159430,145553974,67394544
0,The Exorcism of Emily Rose,122,Crime|Drama|Horror|Thriller,2005,21214702,161026813,139812111
0,Thank You for Smoking,92,Comedy|Drama,2005,7257661,27683521,20425860
0,Deuce Bigalow: European Gigolo,83,Comedy,2005,24564392,25011189,446797
0,Syriana,128,Drama|Thriller,2005,55828164,104956949,49128785
0,Derailed,108,Drama|Thriller,2005,24564392,64179026,39614634
0,Oliver Twist,130,Crime|Drama|Family,2005,55828164,47000286,-8827878
0,The Skeleton Key,104,Drama|Horror|Mystery|Thriller,2005,48012221,102695705,54683484
0,Chaos,106,Drama|Action|Crime,2005,13398759,11488,-13387271
0,Racing Stripes,102,Comedy,2005,33496898,104702955,71206057
0,"Good Night, and Good Luck.",93,Drama|History,2005,7815943,60964355,53148412
0,Coach Carter,136,Drama,2005,33496898,85606690,52109792
0,A History of Violence,96,Drama|Thriller|Crime,2005,35730025,67820977,32090952
0,The Amityville Horror,90,Horror|Thriller|Drama,2005,21214702,120641460,99426758
0,Fun with Dick and Jane,90,Comedy,2005,111656329,225574940,113918611
0,Unleashed,103,Action|Crime,2005,50245348,56800817,6555469
0,Rebound,103,Comedy|Family,2005,50245348,18768327,-31477021
0,Guess Who,105,Comedy|Romance,2005,39079715,76948950,37869235
0,Keeping Mum,103,Comedy,2005,188699,20728664,20539965
0,Two for the Money,122,Comedy|Crime|Drama|Thriller,2005,39079715,34084779,-4994936
0,Harsh Times,120,Crime|Drama|Thriller|Action,2005,2233126,6662575,4429449
0,Flightplan,98,Thriller|Drama|Mystery,2005,61410980,249426057,188015077
0,Assault on Precinct 13,109,Thriller,2005,33496898,39408509,5911611
0,Broken Flowers,105,Comedy|Drama|Mystery|Romance,2005,11165632,51073950,39908318
0,The Weather Man,101,Comedy|Drama,2005,22331265,13937808,-8393457
0,Wolf Creek,99,Horror|Thriller,2005,1116563,30998753,29882190
0,Land of the Dead,93,Horror,2005,16748449,52222337,35473888
0,Walk the Line,136,Drama|Music|Romance,2005,31263772,208170812,176907040
0,A Lot Like Love,107,Comedy,2005,33496898,47885736,14388838
0,Get Rich or Die Tryin',117,Drama,2005,44662531,51856021,7193490
0,Kicking & Screaming,95,Romance|Comedy|Family,2005,50245348,62606187,12360839
0,MirrorMask,101,Adventure|Fantasy|Drama|Science Fiction|Family,2005,4466253,968059,-3498194
0,Cursed,97,Horror|Comedy,2005,39079715,21543978,-17535737
0,Stay,99,Mystery|Thriller|Drama,2005,55828164,9314518,-46513646
0,Ice Princess,98,Comedy,2005,27914082,30867940,2953858
0,The Longest Yard,113,Comedy|Drama,2005,91558189,212504959,120946770
0,Waiting...,94,Comedy,2005,3349689,20810160,17460471
0,Are We There Yet?,95,Comedy|Family|Adventure|Romance,2005,35730025,109332384,73602359
0,A Sound of Thunder,110,Thriller|Science Fiction|Adventure|Action,2005,89325063,6687812,-82637251
0,The Fog,100,Horror|Thriller,2005,20098139,51586822,31488683
0,Stealth,121,Action,2005,150736044,85900499,-64835545
0,The Wedding Date,88,Comedy|Romance,2005,16748449,52673915,35925466
0,BloodRayne,95,Action|Adventure|Fantasy|Horror,2005,27914082,2685803,-25228279
0,Sahara,124,Action|Adventure|Comedy|Drama|Mystery,2005,145153227,133171929,-11981298
0,The Matador,96,Action|Comedy|Crime|Drama|Thriller,2005,11165632,19313467,8147835
0,Capote,114,Crime|Drama,2005,7815943,54806319,46990376
0,Valiant,76,Animation|Family|Adventure,2005,39079715,21748538,-17331177
0,The Constant Gardener,129,Drama|Mystery|Thriller,2005,27914082,92079256,64165174
0,Hard Candy,103,Drama|Thriller,2005,1060735,7840740,6780005
0,House of Wax,113,Horror,2005,44662531,76781726,32119195
0,The Great Raid,132,Action|Adventure|Drama|History|War,2005,89325063,11351542,-77973521
0,Domino,127,Action|Crime,2005,55828164,25618988,-30209176
0,Beauty Shop,105,Comedy|Romance,2005,27914082,40588582,12674500
0,The Adventures of Sharkboy and Lavagirl,92,Adventure|Fantasy|Action|Family,2005,55828164,77518484,21690320
0,The Greatest Game Ever Played,120,Drama|Family,2005,27914082,17229885,-10684197
0,The Three Burials of Melquiades Estrada,121,Adventure|Crime|Drama|Mystery|Western,2005,16748449,13439122,-3309327
0,Cry_Wolf,90,Horror|Thriller,2005,1116563,11218863,10102300
0,Goal!: The Dream Begins,118,Drama,2005,33496898,30829287,-2667611
0,White Noise,101,Drama|Horror|Thriller,2005,11165632,101826573,90660941
0,Brick,110,Drama|Mystery,2005,530367,4376095,3845728
0,Dominion: Prequel to the Exorcist,117,Horror|Thriller|Drama,2005,33496898,280810,-33216088
0,The New World,135,Drama|History|Romance,2005,33496898,34095391,598493
0,Manderlay,139,Drama,2005,15855198,753588,-15101610
0,Sky High,100,Adventure|Comedy|Family,2005,39079715,96437364,57357649
0,The Quiet,96,Drama|Thriller,2005,1004906,425879,-579027
0,Red Eye,85,Horror|Thriller,2005,29030645,64639862,35609217
0,Everything is Illuminated,106,Comedy|Drama,2005,7815943,3012409,-4803534
0,The Ballad of Jack and Rose,111,Drama,2005,1674844,795321,-879523
0,"Yours, Mine & Ours",90,Comedy|Family|Romance,2005,50245348,80424660,30179312
0,The Producers,134,Comedy|Music,2005,50245348,42494539,-7750809
0,Romanzo criminale,152,Drama,2005,913815,5416720,4502905
0,Hustle & Flow,116,Drama,2005,8932506,24789531,15857025
0,Transamerica,103,Drama,2005,1116563,14906531,13789968
0,Alone in the Dark,96,Action|Fantasy|Horror|Thriller,2005,22331265,11660056,-10671209
0,Boogeyman,89,Thriller|Horror|Drama|Mystery,2005,22331265,75025079,52693814
0,Les PoupÃ©es Russes,129,Comedy|Drama|Romance,2005,14515322,26493033,11977711
0,The Cave,97,Action|Adventure|Horror|Thriller,2005,33496898,16757371,-16739527
0,Rent,135,Comedy|Drama|Music|Romance,2005,44662531,35362251,-9300280
0,The Squid and the Whale,81,Comedy|Drama,2005,1674844,12391765,10716921
0,Inside Deep Throat,92,Documentary,2005,2233126,729809,-1503317
0,Man-Thing,97,Action|Horror|Science Fiction,2005,8374224,159668,-8214556
0,Tau man ji D,107,Action|Crime|Thriller|Drama,2005,1729556,7923133,6193577
0,Tamara,98,Fantasy|Horror|Thriller,2005,5303675,230984,-5072691
0,Shopgirl,104,Comedy|Drama|Romance,2005,11483320,12938964,1455644
0,North Country,126,Drama,2005,39079715,28164462,-10915253
0,Conversations with Other Women,84,Drama|Romance,2005,502453,1087002,584549
0,Down in the Valley,112,Drama|Romance,2005,8932506,952285,-7980221
0,Mozart and the Whale,92,Comedy|Drama|Romance,2005,13398759,94871,-13303888
0,Bad News Bears,113,Comedy|Family,2005,33496898,38245471,4748573
0,Because of Winn-Dixie,106,Comedy|Drama|Family,2005,15631886,36450818,20818932
0,Lords of Dogtown,107,Drama,2005,27914082,14975298,-12938784
0,The Proposition,104,Action|Adventure|Crime|Drama|Thriller,2005,2233126,5637185,3404059
0,The Lost City,144,Drama|Romance,2005,10719007,4897510,-5821497
0,Dark Water,105,Drama|Horror|Thriller,2005,33496898,28442320,-5054578
0,Dave Chappelle's Block Party,100,Comedy|Documentary|Music,2005,3349689,13084552,9734863
0,Bee Season,104,Drama|Family,2005,15631886,7656262,-7975624
0,Maurice Richard,124,Drama,2005,8932506,2254351,-6678155
0,Tsotsi,94,Crime|Drama,2005,3349689,11031612,7681923
5,Underworld: Evolution,106,Fantasy|Action|Science Fiction|Thriller,2006,54083457,120433910,66350453
4,Pirates of the Caribbean: Dead Man's Chest,151,Adventure|Fantasy|Action,2006,216333831,1152691352,936357521
3,Cars,117,Animation|Adventure|Comedy|Family,2006,129800299,499712923,369912624
3,Casino Royale,144,Adventure|Action|Thriller,2006,162250373,647969539,485719166
3,The Da Vinci Code,149,Thriller|Mystery,2006,135208644,820164661,684956017
3,Step Up,104,Music|Drama|Romance|Crime,2006,12980029,123521044,110541015
3,Ice Age: The Meltdown,91,Animation|Family|Comedy|Adventure,2006,86533532,714919257,628385725
3,Mission: Impossible III,126,Adventure|Action|Thriller,2006,162250373,430342087,268091714
3,The Devil Wears Prada,109,Comedy|Drama|Romance,2006,37858420,353220247,315361827
2,The Departed,151,Drama|Thriller|Crime,2006,97350224,313518943,216168719
2,The Holiday,136,Comedy|Romance,2006,91941878,210026294,118084416
2,The Prestige,130,Drama|Mystery|Thriller,2006,43266766,118633483,75366717
2,Night at the Museum,108,Action|Adventure|Comedy|Family|Fantasy,2006,118983607,621398207,502414600
2,Babel,143,Drama,2006,27041728,146382484,119340756
2,Children of Men,109,Drama|Action|Thriller|Science Fiction,2006,82206856,75673304,-6533552
1,Superman Returns,154,Adventure|Fantasy|Action|Science Fiction,2006,292050672,423020463,130969791
1,Borat: Cultural Learnings of America for Make Benefit Glorious Nation of Kazakhstan,82,Comedy,2006,19470044,282935169,263465125
1,Click,107,Comedy|Drama|Fantasy|Romance,2006,89237705,257092530,167854825
1,The Break-Up,106,Romance|Comedy,2006,56246796,221741837,165495041
1,Inside Man,129,Crime|Drama|Thriller,2006,48675112,199434107,150758995
1,Over the Hedge,83,Comedy|Animation|Family,2006,86533532,167679639,81146107
1,Perfume: The Story of a Murderer,147,Crime|Fantasy|Drama,2006,54083457,142975378,88891921
1,Blood Diamond,143,Drama|Thriller|Action,2006,108166915,184833371,76666456
1,Crank,88,Action|Thriller|Crime,2006,12980029,46437182,33457153
1,Lucky Number Slevin,110,Drama|Thriller|Crime|Mystery,2006,29205067,60907579,31702512
1,Eight Below,120,Adventure|Drama|Family,2006,43266766,130293533,87026767
1,Final Destination 3,93,Horror|Mystery,2006,27041728,127333182,100291454
1,Silent Hill,125,Horror|Mystery,2006,54083457,105578971,51495514
1,She's the Man,105,Comedy|Drama|Family|Romance,2006,21633383,36656858,15023475
1,The Fountain,96,Drama|Adventure|Science Fiction|Romance,2006,37858420,16554827,-21303593
1,Happy Feet,108,Music|Animation|Comedy|Family,2006,108166915,415723973,307557058
1,Rocky Balboa,102,Drama,2006,25960059,168438745,142478686
1,Flushed Away,85,Adventure|Animation|Comedy|Family,2006,161168704,69723654,-91445050
1,The Wild,94,Family|Animation,2006,86533532,40437169,-46096363
1,DÃ©jÃ  Vu,126,Action|Thriller|Science Fiction,2006,81125186,195303533,114178347
1,Eragon,104,Fantasy|Action|Adventure|Family,2006,108166915,269647254,161480339
1,The Lake House,99,Romance|Drama|Mystery,2006,43266766,124208189,80941423
1,Scary Movie 4,83,Comedy,2006,48675112,192821178,144146066
1,Monster House,91,Animation|Comedy|Family|Fantasy,2006,81125186,151622980,70497794
1,Failure to Launch,97,Comedy,2006,54083457,95960487,41877030
1,Apocalypto,139,Thriller|Action|Adventure|Drama,2006,43266766,129989904,86723138
1,The Ant Bully,88,Fantasy|Adventure|Animation|Comedy|Family,2006,54083457,59687725,5604268
1,The Hills Have Eyes,107,Horror|Thriller,2006,16225037,75309823,59084786
1,Just My Luck,103,Comedy|Drama|Family|Fantasy|Romance,2006,30286736,41276392,10989656
1,The Good Shepherd,167,Drama|Thriller|History,2006,91941878,64801247,-27140631
1,Ultraviolet,88,Science Fiction|Action|Thriller,2006,32450074,33607688,1157614
1,Miami Vice,134,Action|Adventure|Crime|Thriller,2006,146025336,177171468,31146132
1,John Tucker Must Die,87,Comedy,2006,19470044,44358894,24888850
1,Tristan & Isolde,125,Drama,2006,33531743,30286736,-3245007
1,Flags of Our Fathers,132,War|Drama|History,2006,97350224,71282266,-26067958
1,Shortbus,101,Romance|Drama|Comedy,2006,2163338,5602004,3438666
1,Curious George,86,Adventure|Animation|Comedy|Family,2006,54083457,75538165,21454708
1,The Wicker Man,102,Mystery|Thriller|Horror,2006,43266766,41920167,-1346599
1,Smokin' Aces,109,Action|Comedy|Crime|Thriller,2006,18388375,61767522,43379147
0,RV,99,Comedy|Family|Adventure,2006,54083457,94676525,40593068
0,We Are Marshall,124,Drama,2006,70308495,47101677,-23206818
0,The Illusionist,110,Fantasy|Drama|Thriller|Romance,2006,43266766,94013293,50746527
0,Beerfest,110,Comedy,2006,18929210,20746380,1817170
0,The Contract,96,Drama|Action|Thriller|Crime,2006,27041728,6002398,-21039330
0,All the King's Men,125,Drama|Thriller,2006,59491803,10222743,-49269060
0,Big Momma's House 2,99,Comedy|Crime,2006,43266766,149550563,106283797
0,Basic Instinct 2,114,Crime|Mystery|Thriller,2006,75716841,41784314,-33932527
0,Clerks II,97,Comedy,2006,5408345,29084327,23675982
0,Talladega Nights: The Ballad of Ricky Bobby,116,Comedy,2006,78421013,176275487,97854474
0,The Pursuit of Happyness,117,Drama,2006,59491803,332156039,272664236
0,Marie Antoinette,123,Drama|History,2006,43266766,65413228,22146462
0,Freedomland,113,Drama|Thriller|Crime|Mystery,2006,40741068,15852540,-24888528
0,The Last King of Scotland,121,Drama,2006,6490014,51950373,45460359
0,Saw III,108,Horror|Thriller|Crime,2006,10816691,177260496,166443805
0,Idiocracy,84,Adventure|Comedy|Science Fiction,2006,32450074,535753,-31914321
0,Nacho Libre,92,Comedy|Family,2006,34613413,86747695,52134282
0,The Black Dahlia,121,Drama,2006,54083457,53122072,-961385
0,Poseidon,99,Adventure|Action|Drama|Thriller,2006,173067065,196512046,23444981
0,American Dreamz,107,Comedy|Drama|Family,2006,18388375,7911357,-10477018
0,Fur: An Imaginary Portrait of Diane Arbus,122,Drama|Mystery|Romance,2006,18172041,2467383,-15704658
0,"You, Me and Dupree",108,Comedy|Romance,2006,58410134,141083588,82673454
0,Little Miss Sunshine,102,Comedy|Drama,2006,8653353,108732824,100079471
0,Little Man,98,Comedy|Crime,2006,69226826,109892309,40665483
0,Employee of the Month,103,Comedy|Romance,2006,12980029,41502465,28522436
0,The Omen,110,Drama|Horror|Thriller,2006,27041728,128922344,101880616
0,Letters from Iwo Jima,141,Action|Adventure|Drama|War,2006,20551714,74281712,53729998
0,A Scanner Darkly,100,Animation|Science Fiction|Thriller,2006,9194187,5928624,-3265563
0,Stranger Than Fiction,113,Comedy|Drama|Fantasy|Romance,2006,32450074,58035037,25584963
0,World Trade Center,128,Drama|History|Thriller,2006,68145156,176253548,108108392
0,A Good Year,118,Comedy|Drama|Romance,2006,37858420,45499445,7641025
0,Snow Cake,112,Romance|Drama,2006,12980029,1494504,-11485525
0,Itâ€™s a Boy Girl Thing,95,Comedy,2006,16765871,7988596,-8777275
0,Date Movie,83,Comedy,2006,21633383,52513335,30879952
0,Accepted,93,Comedy,2006,24878390,41649680,16771290
0,Open Season,83,Adventure|Animation|Family,2006,91941878,213423089,121481211
0,Barnyard,90,Animation|Comedy|Family,2006,55165127,78722799,23557672
0,Unknown,98,Crime|Drama|Mystery|Thriller,2006,4002175,3610858,-391317
0,Dreamgirls,134,Drama,2006,75716841,167591309,91874468
0,Snakes on a Plane,105,Horror|Action|Crime|Thriller,2006,35695082,67087299,31392217
0,Friends with Money,88,Drama|Comedy|Romance,2006,7030849,14460226,7429377
0,Jackass Number Two,95,Action|Comedy|Documentary,2006,11898360,78722488,66824128
0,The Guardian,139,Action,2006,75716841,59504493,-16212348
0,Southland Tales,144,Action|Adventure|Comedy|Drama|Science Fiction,2006,18388375,405347,-17983028
0,The Fast and the Furious: Tokyo Drift,104,Action|Crime|Drama|Thriller,2006,91941878,171410264,79468386
0,Miss Potter,92,Drama|Family|Romance,2006,32450074,37943051,5492977
0,Pulse,90,Horror|Thriller,2006,41103428,32350220,-8753208
0,Black Snake Moan,116,Drama,2006,16225037,11794353,-4430684
0,Goya's Ghosts,114,Drama,2006,54083457,10219698,-43863759
0,The Hoax,116,Comedy|Drama,2006,27041728,12733907,-14307821
0,The Marine,92,Action|Adventure|Drama|Thriller,2006,21633383,23975854,2342471
0,Running with Scissors,116,Drama|Comedy,2006,12980029,7306564,-5673465
0,The Shaggy Dog,98,Comedy|Family,2006,54083457,66103956,12020499
0,Stormbreaker,93,Adventure|Action|Family,2006,43266766,25892855,-17373911
0,Madea's Family Reunion,110,Drama|Comedy|Romance,2006,6490014,61905574,55415560
0,Charlotte's Web,97,Comedy|Family|Fantasy,2006,91941878,155,-91941723
0,Take the Lead,108,Music,2006,32450074,37579421,5129347
0,Zoom,83,Fantasy|Comedy|Family,2006,37858420,13527557,-24330863
0,Aquamarine,104,Fantasy|Romance|Family|Comedy,2006,12980029,24885798,11905769
0,Rescue Dawn,126,Adventure|Drama|War,2006,10816691,7763294,-3053397
0,The Wind That Shakes the Barley,124,Drama|History|War,2006,7030849,24758344,17727495
0,16 Blocks,105,Action|Adventure|Crime|Thriller,2006,59491803,71027503,11535700
0,Scoop,96,Comedy|Mystery,2006,4326676,34164413,29837737
0,Last Holiday,112,Adventure|Comedy|Drama,2006,48675112,41536053,-7139059
0,Notes on a Scandal,92,Drama|Romance,2006,16225037,53510069,37285032
0,United 93,111,Drama|History|Crime|Thriller|Action,2006,16225037,82516317,66291280
0,Kidulthood,89,Drama,2006,1075179,178475,-896704
0,DOA: Dead or Alive,87,Adventure|Action|Thriller,2006,22715052,519540,-22195512
0,The Queen,103,Drama,2006,16225037,133460805,117235768
0,The Sentinel,108,Action|Thriller|Crime,2006,64900149,84284035,19383886
0,The Good German,108,War|Crime|Drama|Mystery|Romance,2006,34613413,6397973,-28215440
0,Flyboys,140,Action|Adventure|Drama|History|Romance,2006,64900149,19253711,-45646438
0,Running Scared,122,Action|Crime|Drama|Thriller,2006,16225037,10275857,-5949180
0,Catch and Release,111,Comedy|Drama|Romance,2006,27041728,17478137,-9563591
0,The Grudge 2,102,Horror|Thriller,2006,21633383,42340683,20707300
0,10th & Wolf,107,Action|Crime|Drama|Mystery|Thriller,2006,8653353,155166,-8498187
0,Firewall,105,Thriller,2006,48675112,89562206,40887094
0,Seraphim Falls,115,Western|Drama,2006,19470044,1294008,-18176036
0,Sherrybaby,96,Drama,2006,2163338,673670,-1489668
0,Alatriste,145,Action,2006,25960059,25226638,-733421
0,Tenacious D in The Pick of Destiny,93,Comedy|Music,2006,23796721,14500418,-9296303
0,Man of the Year,115,Comedy|Drama|Romance|Thriller,2006,21633383,44605492,22972109
0,The Covenant,97,Action|Adventure|Fantasy|Horror|Science Fiction,2006,21633383,40668024,19034641
0,When a Stranger Calls,87,Horror|Thriller,2006,16225037,72436124,56211087
0,Infamous,110,Drama,2006,14061699,1245358,-12816341
0,Another Gay Movie,92,Comedy|Romance,2006,540834,806197,265363
0,Dhoom 2,147,Drama|Action|Thriller|Crime,2006,11898360,50185584,38287224
0,Black Christmas,84,Horror|Thriller,2006,9735022,23267624,13532602
0,The Astronaut Farmer,104,Adventure|Comedy|Drama|Science Fiction,2006,14061699,12039939,-2021760
0,Fido,91,Romance|Comedy|Drama|Horror,2006,8653353,461033,-8192320
0,ATL,105,Drama,2006,21633383,22899545,1266162
0,Bug,102,Horror|Thriller,2006,4326676,8717323,4390647
0,Lady in the Water,110,Drama|Thriller|Fantasy|Mystery,2006,81125186,45738563,-35386623
0,Gridiron Gang,125,Action|Adventure|Crime|Drama,2006,32450074,44868557,12418483
0,Facing the Giants,111,Drama,2006,108166,11009586,10901420
0,The History Boys,109,Comedy|Drama,2006,4326676,14496478,10169802
0,The Namesake,122,Drama,2006,12980029,21783557,8803528
0,An Inconvenient Truth,100,Documentary,2006,1081669,50019626,48937957
0,Let's Go to Prison,84,Comedy|Crime,2006,4326676,5008176,681500
0,This Is England,101,Drama|Crime,2006,2574372,8844315,6269943
0,School for Scoundrels,100,Comedy|Drama|Romance,2006,21633383,19261898,-2371485
0,Annapolis,108,Drama,2006,28123398,18925956,-9197442
0,IndigÃ¨nes,128,Drama|History|War,2006,15684202,24839127,9154925
0,Flicka,95,Drama|Family,2006,16225037,22715052,6490015
0,Stay Alive,100,Horror|Thriller,2006,9735022,29318745,19583723
0,The Return,85,Drama|Thriller,2006,16225037,12971391,-3253646
0,Ten Canoes,90,Adventure|Comedy|Drama,2006,2163338,324500,-1838838
0,X-Men: The Last Stand,104,Adventure|Action|Science Fiction|Thriller,2006,227150523,253499999,26349476
0,Who Killed the Electric Car?,92,Documentary,2006,1081669,1815986,734317
0,Akeelah and the Bee,112,Drama,2006,8653353,20495926,11842573
0,Trailer Park Boys: The Movie,95,Action|Comedy,2006,5408345,4146586,-1261759
0,First Snow,101,Drama|Thriller,2006,8653353,413486,-8239867
0,For Your Consideration,86,Comedy|Drama,2006,12980029,5994637,-6985392
0,The Foot Fist Way,85,Comedy,2006,85451,265008,179557
0,Special,81,Drama|Fantasy|Science Fiction,2006,1081669,7790,-1073879
5,Harry Potter and the Prisoner of Azkaban,141,Adventure|Fantasy|Family,2004,150077902,911786234,761708332
4,Kill Bill: Vol. 2,136,Action|Crime|Thriller,2004,34633361,175659789,141026428
3,Bridget Jones: The Edge of Reason,108,Comedy|Romance,2004,57722269,46412191,-11310078
3,Eternal Sunshine of the Spotless Mind,108,Science Fiction|Drama|Romance,2004,23088908,83418061,60329153
3,The Notebook,123,Romance|Drama,2004,33478916,133457615,99978699
3,The Incredibles,115,Action|Adventure|Animation|Family|Science Fiction,2004,106208976,728965418,622756442
3,The Bourne Supremacy,108,Action|Drama|Thriller,2004,86583404,333057748,246474344
3,Troy,163,War|Adventure|Drama,2004,202027945,574232515,372204570
2,National Treasure,131,Adventure|Action|Thriller|Mystery,2004,115444540,401114240,285669700
2,"I, Robot",115,Action|Science Fiction,2004,138533448,400863751,262330303
2,50 First Dates,99,Comedy|Romance,2004,86583404,226828759,140245355
2,Mean Girls,97,Comedy,2004,19625571,148972948,129347377
2,Van Helsing,132,Horror|Adventure|Action,2004,184711264,346630860,161919596
2,Hellboy,122,Fantasy|Action|Science Fiction,2004,76193396,114658347,38464951
2,The Polar Express,100,Animation|Adventure|Family|Fantasy,2004,190483491,353116829,162633338
2,Shrek 2,93,Adventure|Animation|Comedy|Family|Fantasy,2004,173166810,1061903623,888736813
2,The Butterfly Effect,113,Science Fiction|Thriller,2004,15007790,110897015,95889225
2,Resident Evil: Apocalypse,94,Horror|Action|Science Fiction,2004,51950042,149379272,97429230
2,Ocean's Twelve,125,Thriller|Crime,2004,126988994,418768465,291779471
2,Meet the Fockers,115,Comedy|Romance,2004,92355631,596436064,504080433
2,The Day After Tomorrow,124,Action|Adventure|Science Fiction|Thriller,2004,144305675,628332770,484027095
1,The Aviator,170,Drama,2004,133915666,117753430,-16162236
1,Collateral,120,Drama|Crime|Thriller,2004,75038950,251396984,176358034
1,Shaun of the Dead,99,Horror|Comedy,2004,4617781,34678837,30061056
1,Blade: Trinity,123,Science Fiction|Action|Horror|Thriller|Adventure,2004,75038950,148814206,73775256
1,The Terminal,128,Comedy|Drama,2004,69266723,253305240,184038517
1,Lemony Snicket's A Series of Unfortunate Events,108,Adventure|Fantasy|Comedy|Family,2004,161622356,241364107,79741751
1,Million Dollar Baby,132,Drama,2004,34633361,250241794,215608433
1,Garfield,80,Animation|Comedy|Family,2004,57722269,231817870,174095601
1,Shark Tale,90,Animation|Action|Comedy|Family,2004,86583404,423998956,337415552
1,Sky Captain and the World of Tomorrow,107,Mystery|Action|Thriller|Science Fiction|Adventure,2004,80811177,66910149,-13901028
1,The SpongeBob SquarePants Movie,87,Animation|Comedy|Family,2004,34633361,161809136,127175775
1,Crash,112,Drama,2004,7503895,113609042,106105147
1,Anchorman: The Legend of Ron Burgundy,94,Comedy,2004,30015580,104562954,74547374
1,13 Going On 30,98,Comedy|Fantasy|Romance,2004,42714479,111352835,68638356
1,Ella Enchanted,96,Fantasy|Comedy|Family|Romance,2004,35787807,31618836,-4168971
1,The Girl Next Door,108,Comedy,2004,28861135,35108050,6246915
1,Finding Neverland,106,Drama,2004,28861135,134800613,105939478
1,A Cinderella Story,95,Comedy,2004,21934462,80889575,58955113
1,AVP: Alien vs. Predator,101,Adventure|Science Fiction|Action,2004,80811177,197622423,116811246
1,DodgeBall: A True Underdog Story,92,Comedy,2004,23088908,193626249,170537341
1,Banlieue 13,84,Action|Thriller|Science Fiction,2004,13853344,11064355,-2788989
1,Alexander,175,War|History|Action|Adventure|Drama,2004,178939037,193136628,14197591
1,Harold & Kumar Go to White Castle,88,Comedy|Adventure,2004,10390008,27633853,17243845
1,Saw,103,Horror|Mystery|Crime,2004,1385334,119960348,118575014
1,Spider-Man 2,127,Action|Adventure|Fantasy,2004,230889080,904815446,673926366
1,EuroTrip,93,Comedy,2004,28861135,24008824,-4852311
1,Man on Fire,146,Action|Drama|Thriller|Crime,2004,80811177,150416978,69605801
1,Along Came Polly,90,Comedy|Romance,2004,48486706,198522339,150035633
1,Closer,104,Drama|Romance,2004,31170025,133344247,102174222
1,The Punisher,124,Action|Crime|Drama,2004,38096698,63148284,25051586
1,Catwoman,104,Action|Crime,2004,115444540,94782713,-20661827
1,9 Songs,66,Drama|Music|Romance,2004,1154445,383648,-770797
1,Dawn of the Dead,101,Fantasy|Horror|Action,2004,32324471,118164853,85840382
1,King Arthur,126,Adventure|War|History,2004,138533448,235007976,96474528
1,The Chronicles of Riddick,119,Adventure|Action|Thriller|Science Fiction,2004,121216767,133653299,12436532
1,Spanglish,130,Comedy,2004,92355631,63542252,-28813379
1,Secret Window,96,Thriller|Mystery,2004,46177815,107263182,61085367
1,Layer Cake,105,Drama|Thriller|Crime,2004,7503895,13680425,6176530
0,After the Sunset,97,Action|Comedy|Crime|Drama,2004,69266723,70822682,1555959
0,Thunderbirds,95,Action|Adventure|Comedy|Family|Fantasy,2004,65803387,32651914,-33151473
0,The Princess Diaries 2: Royal Engagement,113,Comedy|Drama|Family|Romance,2004,46177815,109844827,63667012
0,The Alamo,137,Western|History|War,2004,167394583,29807735,-137586848
0,Before Sunset,80,Drama|Romance,2004,3117002,18462600,15345598
0,The Grudge,92,Horror|Thriller|Mystery,2004,11544454,211811410,200266956
0,Cellular,94,Action|Adventure|Crime|Thriller,2004,28861135,65136911,36275776
0,The Manchurian Candidate,129,Drama|Thriller|Mystery,2004,92355631,110949088,18593457
0,The Machinist,101,Thriller|Drama,2004,5772226,9470186,3697960
0,Seed of Chucky,87,Comedy|Drama|Horror,2004,13853344,28664468,14811124
0,Taxi,97,Thriller|Action|Comedy|Crime,2004,28861135,42264206,13403071
0,Alfie,103,Comedy,2004,69266723,15464880,-53801843
0,Shall We Dance?,107,Drama|Romance|Comedy,2004,57722269,196404018,138681749
0,Jersey Girl,102,Comedy|Romance,2004,40405588,41673611,1268023
0,The Stepford Wives,93,Action|Comedy|Science Fiction,2004,103900086,117753430,13853344
0,Primer,79,Science Fiction|Drama|Thriller,2004,8081,490362,482281
0,ã‚¢ãƒƒãƒ—ãƒ«ã‚·ãƒ¼ãƒ‰,101,Animation|Action|Science Fiction,2004,11544454,1687786,-9856668
0,Home on the Range,76,Western|Animation|Family|Comedy|Music,2004,126988994,120006286,-6982708
0,Hidalgo,136,Western|Adventure,2004,115444540,124799530,9354990
0,Fahrenheit 9/11,122,Documentary,2004,6926672,137511206,130584534
0,Win a Date with Tad Hamilton!,95,Comedy|Romance,2004,19625571,19602596,-22975
0,White Chicks,109,Comedy,2004,42714479,130552160,87837681
0,Hotel Rwanda,121,Drama|History|War,2004,20202794,43868925,23666131
0,Walking Tall,86,Adventure|Drama|Action|Thriller,2004,64648942,66061856,1412914
0,Twisted,97,Action|Adventure|Crime|Drama|Thriller,2004,57722269,29086251,-28636018
0,Open Water,79,Drama|Thriller,2004,150077,63111168,62961091
0,Team America: World Police,98,Music|Adventure|Animation|Action|Comedy,2004,36942252,58769839,21827587
0,Sideways,126,Comedy|Drama|Romance,2004,18471126,126414430,107943304
0,Without a Paddle,95,Action|Adventure|Comedy|Thriller,2004,21934462,80385323,58450861
0,Starsky & Hutch,101,Comedy|Crime,2004,69266723,196565975,127299252
0,Confessions of a Teenage Drama Queen,89,Music|Comedy|Family|Romance,2004,17316681,33861116,16544435
0,The Village,108,Drama|Mystery|Thriller,2004,69266723,296343271,227076548
0,The Whole Ten Yards,98,Comedy|Thriller|Crime,2004,46177815,30195421,-15982394
0,The Passion of the Christ,127,Drama,2004,34633361,706404470,671771109
0,Anacondas: The Hunt for the Blood Orchid,97,Adventure|Action|Horror|Science Fiction|Thriller,2004,23088908,81957424,58868516
0,Ray,152,Drama,2004,46177815,143995745,97817930
0,Dirty Dancing: Havana Nights,86,Drama|Romance,2004,28861135,31960839,3099704
0,Wimbledon,98,Comedy|Romance,2004,35787807,47923345,12135538
0,Taking Lives,103,Action|Drama|Mystery|Thriller,2004,51950042,75582151,23632109
0,The Phantom of the Opera,143,Thriller|Drama|Romance,2004,80811177,178533696,97722519
0,Garden State,102,Comedy|Drama|Romance,2004,2886113,30918036,28031923
0,Napoleon Dynamite,95,Comedy,2004,461778,53240824,52779046
0,Exorcist: The Beginning,114,Horror|Mystery|Thriller,2004,92355631,90047417,-2308214
0,Wicker Park,114,Drama|Mystery|Romance|Thriller,2004,34633361,15009241,-19624120
0,The Life Aquatic with Steve Zissou,119,Adventure|Comedy|Drama,2004,57722269,40184400,-17537869
0,Around the World in 80 Days,120,Action|Adventure|Comedy,2004,126988994,83326593,-43662401
0,Barbershop 2:  Back in Business,106,Comedy|Drama,2004,20780017,75120237,54340220
0,The Forgotten,91,Crime|Drama|Horror|Mystery|Science Fiction,2004,48486706,135734652,87247946
0,Surviving Christmas,91,Comedy|Romance,2004,51950042,17078431,-34871611
0,Flight of the Phoenix,113,Action|Adventure|Drama|Thriller,2004,51950042,24253951,-27696091
0,Godsend,102,Drama|Horror|Science Fiction|Thriller,2004,28861135,34765530,5904395
0,It's All Gone Pete Tong,90,Drama|Comedy|Music,2004,2308890,139249,-2169641
0,Friday Night Lights,118,Drama,2004,34633361,70716616,36083255
0,Raising Helen,119,Drama|Comedy|Romance,2004,57722269,57397421,-324848
0,She Hate Me,138,Comedy|Drama,2004,9235563,421527,-8814036
0,Paparazzi,84,Action|Drama|Thriller,2004,23088908,19170446,-3918462
0,Raise Your Voice,103,Music|Drama|Romance,2004,17316681,17163733,-152948
0,Vanity Fair,141,Drama|Romance,2004,26552244,18614105,-7938139
0,Deux frÃ¨res,109,Adventure|Drama|Family,2004,86006182,71774237,-14231945
0,Torque,84,Action,2004,46177815,53735043,7557228
0,Miracle,135,Drama|History,2004,32324471,74399051,42074580
0,Mindhunters,106,Mystery|Thriller|Crime,2004,31170025,24415168,-6754857
0,Soul Plane,86,Comedy,2004,18471126,17111589,-1359537
0,Club Dread,104,Comedy|Horror,2004,9812785,5774137,-4038648
0,Chasing Liberty,111,Comedy|Romance,2004,26552244,13,-26552231
0,Suspect Zero,99,Crime|Thriller,2004,31170025,15007790,-16162235
0,The Big Bounce,88,Comedy|Crime,2004,57722269,7860099,-49862170
0,The Heart is Deceitful Above All Things,98,Drama,2004,85486,203359,117873
0,Mr. 3000,104,Comedy|Drama,2004,34633361,25167258,-9466103
0,Connie and Carla,98,Comedy,2004,23088908,13092583,-9996325
0,Spartan,102,Mystery|Action|Drama|Thriller|Crime,2004,22223073,9365683,-12857390
0,Agent Cody Banks 2: Destination London,100,Comedy,2004,30015580,33269956,3254376
0,Johnson Family Vacation,97,Comedy|Family,2004,13853344,35995048,22141704
0,Super Size Me,100,Documentary|Comedy|Drama,2004,75038,32988367,32913329
0,A Home at the End of the World,96,Romance|Drama,2004,7503895,1788183,-5715712
0,Little Black Book,111,Comedy|Romance|Drama,2004,40405588,25438010,-14967578
0,Against the Ropes,106,Romance|Drama,2004,45023370,7635825,-37387545
0,A Dirty Shame,89,Comedy,2004,17316681,2209800,-15106881
0,Ladder 49,115,Drama|Action|Thriller,2004,69266723,86054330,16787607
0,Catch That Kid,92,Family|Action|Adventure,2004,20780017,19282544,-1497473
0,Il cartaio,103,Horror,2004,3001558,1707473,-1294085
0,Riding Giants,105,Documentary,2004,3001558,3654974,653416
0,Mean Creek,90,Crime|Drama,2004,577222,697219,119997
0,We Don't Live Here Anymore,101,Drama|Romance,2004,3463336,2352234,-1111102
0,Welcome to Mooseport,110,Comedy,2004,34633361,16162235,-18471126
0,Never Die Alone,88,Action|Adventure|Crime|Drama|Thriller,2004,3463336,6837780,3374444
0,Narco,105,Comedy,2004,950406,950406,0
0,Born into Brothels,85,Documentary,2004,404055,4057946,3653891
5,The Godfather,175,Drama|Crime,1972,31287365,1277913732,1246626367
0,Deliverance,109,Drama|Adventure|Thriller,1972,10429121,240507830,230078709
0,Conquest of the Planet of the Apes,88,Action|Science Fiction,1972,9386209,50581241,41195032
0,Frenzy,116,Crime|Drama|Mystery|Thriller,1972,18250963,65703467,47452504
0,Pink Flamingos,93,Comedy,1972,62574,31287365,31224791
0,Everything You Always Wanted to Know About Sex *But Were Afraid to Ask,88,Comedy,1972,10429121,93947041,83517920
0,The Poseidon Adventure,117,Action|Adventure,1972,26072804,440959531,414886727
0,The Getaway,118,Action|Crime|Thriller,1972,17480532,306783033,289302501
5,The Empire Strikes Back,124,Adventure|Action|Science Fiction,1980,47628661,1424626188,1376997527
2,The Shining,144,Horror|Thriller,1980,50274698,116471589,66196891
1,Airplane!,88,Comedy|Romance,1980,9261128,220821131,211560003
1,The Blues Brothers,133,Music|Comedy|Action|Crime,1980,71442992,304902524,233459532
1,The Blue Lagoon,104,Romance|Adventure|Drama,1980,11907165,155727481,143820316
1,Raging Bull,129,Drama,1980,47628661,60858845,13230184
1,Superman II,127,Action|Adventure|Fantasy|Science Fiction,1980,142885984,286263354,143377370
1,Friday the 13th,95,Horror,1980,1455320,158112870,156657550
0,Flash Gordon,111,Science Fiction,1980,92611286,71728658,-20882628
0,The Elephant Man,124,Drama|History,1980,13230183,68825702,55595519
0,The Fog,89,Horror,1980,2646036,56567928,53921892
0,Caddyshack,98,Comedy,1980,15876220,105434890,89558670
0,Dressed to Kill,105,Horror|Mystery|Thriller,1980,17199238,84405926,67206688
0,Used Cars,113,Action|Comedy,1980,21168294,30999169,9830875
0,Heaven's Gate,219,Action|Drama|History|Western,1980,116425617,9219667,-107205950
0,Altered States,102,Mystery|Drama|Fantasy|Science Fiction|Thriller,1980,39690551,52534127,12843576
0,American Gigolo,117,Thriller|Drama|Crime|Romance,1980,12700976,60180597,47479621
0,Atlantic City,104,Crime|Drama|Romance,1980,19051464,33683195,14631731
0,Stardust Memories,89,Comedy|Drama|Romance,1980,26460367,27489683,1029316
0,Prom Night,92,Horror|Mystery|Thriller,1980,2646036,39151384,36505348
0,Battle Beyond the Stars,104,Science Fiction,1980,5292073,29106404,23814331
0,Xanadu,96,Fantasy|Music|Romance,1980,52920735,59460666,6539931
0,The Long Riders,99,Western|History,1980,26460367,41794650,15334283
4,Pirates of the Caribbean: At World's End,169,Adventure|Fantasy|Action,2007,315500574,1010653508,695152934
4,Harry Potter and the Order of the Phoenix,138,Adventure|Fantasy|Family|Mystery,2007,157750287,986688860,828938573
2,Ratatouille,111,Animation|Comedy|Family|Fantasy,2007,157750287,655949692,498199405
2,The Bourne Ultimatum,115,Action|Drama|Mystery|Thriller,2007,73616800,465704233,392087433
2,No Country for Old Men,122,Crime|Drama|Thriller,2007,26291714,180466328,154174614
2,I Am Legend,101,Drama|Horror|Action|Thriller|Science Fiction,2007,157750287,615593163,457842876
2,National Treasure: Book of Secrets,124,Action|Adventure|Mystery|Thriller,2007,136716915,480994474,344277559
2,Spider-Man 3,139,Fantasy|Action|Adventure,2007,271330494,936901700,665571206
2,The Mist,126,Science Fiction|Horror|Thriller,2007,18930034,60046269,41116235
2,Stardust,127,Adventure|Fantasy|Romance|Family,2007,73616800,142564220,68947420
2,Death Proof,113,Action|Thriller,2007,26291714,26331569,39855
2,Live Free or Die Hard,128,Action|Thriller,2007,115683544,403347991,287664447
2,Rush Hour 3,91,Action|Comedy|Crime|Thriller,2007,147233601,271353876,124120275
2,Into the Wild,148,Adventure|Drama,2007,15775028,59161765,43386737
2,300,117,Action|Adventure|War,2007,68358457,444446100,376087643
2,Ghost Rider,114,Thriller|Action|Fantasy|Horror,2007,115683544,240556981,124873437
2,Juno,96,Comedy|Drama|Romance,2007,7887514,243368292,235480778
2,Bridge to Terabithia,96,Adventure|Drama|Family,2007,63100114,144695991,81595877
2,Shooter,124,Action|Drama|Mystery|Thriller|Crime,2007,64151783,100641524,36489741
2,Atonement,123,Drama|Romance,2007,31550057,135945055,104394998
2,There Will Be Blood,158,Drama,2007,26291714,80117737,53826023
1,American Gangster,157,Drama|Crime,2007,105166858,280232907,175066049
1,Shrek the Third,93,Fantasy|Adventure|Animation|Comedy|Family,2007,168266973,840239201,671972228
1,Sweeney Todd: The Demon Barber of Fleet Street,116,Drama|Horror|Music,2007,52583429,159853624,107270195
1,Superbad,113,Comedy,2007,21033371,178637114,157603743
1,Alvin and the Chipmunks,92,Comedy|Music|Family|Fantasy|Animation,2007,63100114,380037934,316937820
1,Bee Movie,91,Family|Animation|Adventure|Comedy,2007,157750287,302454181,144703894
1,Meet the Robinsons,95,Animation|Comedy|Family,2007,157750287,178082173,20331886
1,P.S. I Love You,126,Drama|Romance,2007,31550057,164938798,133388741
1,Knocked Up,129,Comedy|Romance|Drama,2007,31550057,230395891,198845834
1,The Number 23,101,Thriller|Drama|Mystery,2007,31550057,81574582,50024525
1,4: Rise of the Silver Surfer,92,Adventure|Fantasy|Action|Thriller,2007,136716915,303982451,167265536
1,Enchanted,107,Comedy|Family|Fantasy|Romance,2007,89391829,358080166,268688337
1,Zodiac,157,Crime|Drama|Mystery|Thriller,2007,68358457,89166682,20808225
1,Ocean's Thirteen,122,Crime|Thriller,2007,89391829,327397706,238005877
1,TMNT,90,Comedy|Adventure|Fantasy|Action|Science Fiction,2007,35756731,100548976,64792245
1,The Simpsons Movie,87,Animation|Comedy|Family,2007,78875143,554301751,475426608
1,Charlie Wilson's War,102,Comedy|Drama|History,2007,78875143,125148992,46273849
1,28 Weeks Later,100,Horror|Thriller|Science Fiction,2007,15775028,67557549,51782521
1,The Kingdom,110,Thriller|Action|Drama,2007,73616800,91136082,17519282
1,Aliens vs Predator: Requiem,94,Fantasy|Action|Science Fiction|Thriller|Horror,2007,42066743,43956661,1889918
1,Sunshine,107,Science Fiction|Thriller,2007,52583429,33672117,-18911312
1,Mr. Bean's Holiday,90,Family|Comedy,2007,26291714,241606495,215314781
1,Mr. Brooks,120,Drama|Crime|Mystery|Thriller,2007,21033371,43788601,22755230
1,30 Days of Night,113,Horror|Thriller,2007,31550057,79407259,47857202
1,The Golden Compass,113,Adventure|Fantasy,2007,189300344,391467711,202167367
1,Once,85,Drama|Music|Romance,2007,168266,21780595,21612329
1,88 Minutes,108,Crime|Mystery|Thriller,2007,31550057,17805678,-13744379
1,The Brave One,122,Crime|Drama|Thriller,2007,73616800,73371361,-245439
1,Disturbia,105,Thriller|Drama|Mystery,2007,21033371,123844633,102811262
1,Lions for Lambs,92,Action|Adventure|Drama|History,2007,36808400,66482146,29673746
1,3:10 to Yuma,122,Western,2007,57841772,73633858,15792086
1,August Rush,114,Drama,2007,26291714,69538457,43246743
1,Awake,84,Thriller|Crime|Mystery,2007,90443498,15116500,-75326998
1,War,103,Action|Thriller|Crime,2007,26291714,42542773,16251059
1,Paranormal Activity,86,Horror|Mystery,2007,15775,203346220,203330445
1,Evan Almighty,96,Fantasy|Comedy|Family,2007,184042002,181938664,-2103338
1,I Now Pronounce You Chuck & Larry,115,Comedy|Romance,2007,89391829,195686301,106294472
1,Next,96,Action|Science Fiction|Thriller,2007,73616800,19151950,-54464850
1,Premonition,110,Fantasy|Drama|Mystery,2007,21033371,88494579,67461208
1,Saw IV,93,Horror|Thriller|Crime,2007,10516685,146552786,136036101
1,Fred Claus,116,Action|Comedy|Drama,2007,105166858,102893517,-2273341
1,Hairspray,117,Comedy|Music|Romance,2007,52583429,95123431,42540002
0,Shoot 'Em Up,86,Action|Thriller|Comedy|Crime,2007,41015074,28206425,-12808649
0,Eastern Promises,100,Thriller|Crime|Mystery,2007,54160932,57959933,3799001
0,Beowulf,115,Animation|Fantasy,2007,73616800,205849271,132232471
0,No Reservations,104,Comedy,2007,29446720,97385615,67938895
0,The Heartbreak Kid,116,Comedy,2007,63100114,134368171,71268057
0,Surf's Up,85,Animation|Comedy|Family,2007,89391829,156745431,67353602
0,1408,104,Horror|Thriller,2007,26291714,99571558,73279844
0,Hitman,89,Action|Crime|Drama|Thriller,2007,25240045,105130841,79890796
0,The Game Plan,110,Comedy|Family,2007,23136708,155521321,132384613
0,Grindhouse,191,Thriller|Action|Horror,2007,70461795,26331569,-44130226
0,Run Fatboy Run,100,Comedy|Romance,2007,10516685,34705063,24188378
0,The Messengers,90,Thriller|Drama|Horror,2007,16826697,1166994,-15659703
0,Transformers,144,Adventure|Science Fiction|Action,2007,157750287,746379478,588629191
0,The Bucket List,97,Comedy|Drama|Adventure,2007,47325086,184433750,137108664
0,Hostel: Part II,93,Horror,2007,10727019,37459931,26732912
0,The Hitcher,84,Action|Horror|Crime,2007,10516685,26712324,16195639
0,I Know Who Killed Me,105,Crime|Horror|Mystery|Thriller,2007,12620022,10117471,-2502551
0,Halloween,109,Horror,2007,15775028,84400513,68625485
0,Becoming Jane,120,Drama|Romance,2007,17352531,39239513,21886982
0,Funny Games,112,Horror|Thriller|Crime,2007,15775028,8349062,-7425966
0,Elizabeth: The Golden Age,114,Drama|History|Romance,2007,26291714,78073312,51781598
0,The Invasion,99,Science Fiction|Thriller,2007,84133486,15850237,-68283249
0,Before the Devil Knows You're Dead,117,Crime|Drama|Thriller,2007,18930034,26297243,7367209
0,Daddy Day Camp,89,Comedy|Family,2007,6310011,19137631,12827620
0,Waitress,108,Comedy,2007,2103337,23325409,21222072
0,P2,98,Horror|Thriller,2007,8413348,8167510,-245838
0,Resident Evil: Extinction,94,Horror|Action|Science Fiction,2007,47325086,155350204,108025118
0,Diary of the Dead,95,Horror|Action|Science Fiction,2007,2103337,5642052,3538715
0,The Assassination of Jesse James by the Coward Robert Ford,160,Action|Drama|Western,2007,31550057,15471930,-16078127
0,A Mighty Heart,100,Drama|Thriller,2007,16826697,19906898,3080201
0,Death at a Funeral,90,Comedy|Drama,2007,9465017,48,-9464969
0,The Reaping,99,Horror,2007,42066743,66014350,23947607
0,Perfect Stranger,109,Crime|Drama|Mystery|Thriller,2007,63936191,76867099,12930908
0,KatyÅ„,118,Drama|History|War,2007,5468676,15484045,10015369
0,Norbit,101,Comedy,2007,63100114,100616926,37516812
0,Music and Lyrics,96,Comedy|Music|Romance,2007,42066743,153434683,111367940
0,Rendition,120,Drama|Thriller,2007,28920886,26027398,-2893488
0,Flawless,108,Crime|Drama|Thriller,2007,21033371,7171945,-13861426
0,In the Valley of Elah,124,History|Drama|Thriller|Crime|Mystery,2007,24188377,31068172,6879795
0,Good Luck Chuck,101,Comedy|Drama|Romance,2007,26291714,62250501,35958787
0,Epic Movie,86,Action|Adventure|Comedy,2007,21033371,91353784,70320413
0,In the Land of Women,97,Romance|Comedy|Drama,2007,10516685,18404200,7887515
0,Battle for Terra,85,Science Fiction|Action|Adventure|Animation|Family,2007,4206674,6416278,2209604
0,The Nanny Diaries,106,Comedy|Drama|Romance,2007,21033371,50204658,29171287
0,The Great Debaters,126,Drama,2007,15775028,31787886,16012858
0,Freedom Writers,123,Crime|Drama,2007,22085040,43298020,21212980
0,The Invisible,102,Action|Adventure|Crime|Drama|Fantasy,2007,31550057,28195353,-3354704
0,La terza madre,102,Horror,2007,3680840,57786,-3623054
0,We Own the Night,117,Drama|Crime|Thriller,2007,22085040,57764880,35679840
0,The Kite Runner,128,Drama,2007,21033371,77062116,56028745
0,Vacancy,80,Horror|Thriller,2007,19981703,37124579,17142876
0,Dan in Real Life,98,Comedy|Romance|Drama,2007,26291714,71910846,45619132
0,Sydney White,108,Comedy,2007,17352531,14323804,-3028727
0,Captivity,96,Crime|Horror|Thriller,2007,17878365,2762523,-15115842
0,License to Wed,91,Comedy,2007,36808400,72888230,36079830
0,I Could Never Be Your Woman,97,Comedy|Drama|Romance,2007,25240045,10071298,-15168747
0,Michael Clayton,119,Drama|Mystery|Crime,2007,26291714,97796591,71504877
0,Lars and the Real Girl,106,Comedy|Romance|Drama,2007,12620022,11877190,-742832
0,The Water Horse,112,Fantasy|Adventure|Family,2007,47325086,108396998,61071912
0,Death Sentence,105,Action|Crime|Drama|Thriller,2007,21033371,17851505,-3181866
0,The Death and Life of Bobby Z,97,Drama|Action|Thriller|Crime,2007,23136708,434816,-22701892
0,The Lookout,99,Crime|Drama|Thriller,2007,16826697,5644336,-11182361
0,Sicko,123,Documentary,2007,9465017,25806383,16341366
0,Pathfinder,99,Action,2007,47325086,32415434,-14909652
0,Gone Baby Gone,113,Crime|Drama|Mystery,2007,19981703,36408449,16426746
0,Walk Hard: The Dewey Cox Story,96,Comedy|Music,2007,36808400,19263572,-17544828
0,Meet Bill,97,Comedy|Drama|Romance,2007,5258342,364499,-4893843
0,Things We Lost in the Fire,113,Drama,2007,16826697,2996353,-13830344
0,Death Defying Acts,97,Drama|Romance,2007,21033371,3744,-21029627
0,Reign Over Me,124,Drama,2007,21033371,23370503,2337132
0,Love in the Time of Cholera,139,Drama|Romance,2007,47325086,4845676,-42479410
0,I'm Not There.,135,Drama|Music,2007,21033371,4207853,-16825518
0,Gracie,97,Drama|Family,2007,9465017,3107721,-6357296
0,Earth,90,Documentary,2007,15775028,114631875,98856847
0,The Good Night,93,Comedy|Drama|Romance|Fantasy|Music,2007,15775028,21433,-15753595
0,The Last Legion,102,Action|Adventure|Fantasy|War,2007,70461795,26610410,-43851385
0,Whisper,94,Crime|Drama|Horror|Thriller,2007,12620022,5558275,-7061747
0,My Blueberry Nights,111,Drama|Romance,2007,10516685,22912427,12395742
0,You Kill Me,90,Comedy|Crime|Thriller|Romance,2007,4206674,2552242,-1654432
0,The Darjeeling Limited,91,Adventure|Drama|Comedy,2007,16826697,25636683,8809986
0,Stomp the Yard,114,Drama|Music,2007,13671691,79412675,65740984
0,Virgin Territory,93,Adventure|Action|Comedy|Romance,2007,39963406,5690314,-34273092
0,Hallam Foe,95,Drama|Comedy|Thriller,2007,8413348,63774,-8349574
0,Dead Silence,89,Horror,2007,21033371,23365348,2331977
0,The Signal,103,Horror|Action|Thriller|Science Fiction,2007,52583,262817,210234
0,Battle in Seattle,99,Action|Drama,2007,8413348,955805,-7457543
0,Boy Culture,88,Drama|Romance,2007,525834,231525,-294309
0,Son of Rambow,96,Comedy,2007,4206674,7225225,3018551
0,I Think I Love My Wife,90,Comedy|Romance,2007,11568354,13878076,2309722
0,December Boys,105,Drama|Romance,2007,4206674,48875,-4157799
0,Hannibal Rising,121,Crime|Drama|Thriller,2007,52583429,86415485,33832056
0,Taxi to the Dark Side,106,Documentary,2007,1051668,288852,-762816
0,Why Did I Get Married?,113,Comedy|Drama,2007,15775028,58036037,42261009
0,Ji jie hao,124,Action|History,2007,16826697,36584352,19757655
0,The Tracey Fragments,77,Drama,2007,736168,33207,-702961
0,Daddy's Little Girls,100,Comedy|Drama|Romance,2007,10516685,33242447,22725762
0,My Name Is Bruce,86,Comedy|Horror,2007,1577502,182008,-1395494
0,Reno 911!: Miami,84,Action|Adventure|Comedy|Crime,2007,10516685,21393211,10876526
0,Code Name: The Cleaner,84,Action|Comedy|Crime,2007,21033371,10871599,-10161772
0,Partner,155,Comedy|Foreign|Romance,2007,464723,1083613,618890
0,Loose Change: Final Cut,129,Documentary,2007,6310,6310,0
0,No End in Sight,102,Documentary,2007,2103337,1505592,-597745
4,Alien,117,Horror|Action|Thriller|Science Fiction,1979,33050094,315273262,282223168
2,Apocalypse Now,153,Drama|War,1979,94643451,250794662,156151211
2,Mad Max,93,Adventure|Action|Thriller|Science Fiction,1979,1201821,300455400,299253579
1,Star Trek: The Motion Picture,132,Science Fiction|Adventure|Mystery,1979,105159390,417633006,312473616
1,Moonraker,126,Action|Adventure|Thriller|Science Fiction,1979,102154836,631857706,529702870
1,Life of Brian,94,Comedy,1979,12018216,60226630,48208414
1,Rocky II,119,Drama,1979,21031878,601458110,580426232
0,Caligola,156,Drama|History|Romance,1979,52579695,70421097,17841402
0,Phantasm,89,Horror|Science Fiction,1979,901366,36020002,35118636
0,Escape from Alcatraz,111,Crime|Drama,1979,24036432,129195822,105159390
0,The Black Hole,98,Adventure|Family|Science Fiction|Action,1979,60091080,107688927,47597847
0,The Concorde... Airport '79,123,Action|Drama|Thriller,1979,42063756,39106337,-2957419
0,Kramer vs. Kramer,105,Drama,1979,24036432,319263908,295227476
0,1941,113,Action|Comedy,1979,105159390,95411841,-9747549
0,Breaking Away,100,Drama|Comedy,1979,6910474,60091080,53180606
0,The Black Stallion,118,Adventure|Family,1979,8112295,113571068,105458773
4,The Terminator,108,Action|Thriller|Science Fiction,1984,13433869,164504443,151070574
2,Indiana Jones and the Temple of Doom,118,Adventure|Action,1984,58773177,698980999,640207822
2,Ghostbusters,107,Fantasy|Action|Comedy|Science Fiction|Family,1984,62971261,619663378,556692117
2,Gremlins,106,Fantasy|Horror|Comedy,1984,23089462,321327866,298238404
2,The Neverending Story,102,Drama|Family|Fantasy|Adventure,1984,56674135,42314185,-14359950
2,Beverly Hills Cop,105,Action|Comedy|Crime,1984,31485630,664053942,632568312
1,Amadeus,160,Drama|History|Music,1984,37782756,109093572,71310816
1,The Karate Kid,126,Drama,1984,16792336,190625674,173833338
1,A Nightmare on Elm Street,91,Horror,1984,3778275,53535044,49756769
1,Conan the Destroyer,103,Adventure|Fantasy|Action,1984,37782756,65158536,27375780
1,2010,116,Thriller|Science Fiction,1984,58773177,84802677,26029500
1,Dune,137,Action|Science Fiction|Adventure,1984,83961681,64914323,-19047358
0,Romancing the Stone,106,Action|Adventure|Comedy|Romance,1984,20990420,181718767,160728347
0,Police Academy,96,Comedy|Crime,1984,9445689,170439892,160994203
0,Star Trek III: The Search for Spock,105,Science Fiction|Action|Adventure|Thriller,1984,37782756,182616657,144833901
0,Footloose,107,Drama|Family|Music|Romance,1984,17212144,167997673,150785529
0,Repo Man,92,Comedy|Drama|Science Fiction,1984,3148563,4827796,1679233
0,Starman,115,Action|Adventure|Drama|Romance|Science Fiction,1984,46178924,60335611,14156687
0,Bachelor Party,105,Comedy,1984,12594252,80678668,68084416
0,Sixteen Candles,93,Comedy|Romance,1984,13643773,49717966,36074193
0,The Killing Fields,141,War|Drama|History,1984,30226205,72837369,42611164
0,Night of the Comet,95,Action|Comedy|Horror|Science Fiction|Thriller,1984,6297126,30265923,23968797
0,The Last Starfighter,101,Adventure|Science Fiction|Action,1984,31485630,60312383,28826753
0,Sheena,117,Adventure|Fantasy|Action|Comedy|Science Fiction,1984,52476050,12129005,-40347045
0,Splash,111,Comedy|Fantasy|Romance,1984,16792336,146557915,129765579
0,"Paris, Texas",147,Drama,1984,3666950,4580082,913132
0,Body Double,114,Mystery|Thriller,1984,20990420,18475642,-2514778
0,City Heat,93,Action|Comedy|Crime,1984,52476050,80496137,28020087
0,The Cotton Club,127,Music|Drama|Crime|Romance,1984,121744438,54425475,-67318963
0,Top Secret!,90,Comedy,1984,18891378,42942915,24051537
0,Purple Rain,111,Drama|Music|Romance,1984,15113102,143559733,128446631
0,Missing in Action,101,Action|Adventure|Thriller|War,1984,5352557,47884209,42531652
0,The Natural,137,Drama,1984,58773177,100653219,41880042
0,Children of the Corn,93,Drama|Fantasy|Horror|Thriller,1984,1679233,29386588,27707355
0,A Passage to India,163,Drama|Adventure|History,1984,16792336,57068026,40275690
0,Streets of Fire,93,Action|Thriller|Music,1984,30436109,16979759,-13456350
0,Stop Making Sense,88,Documentary|Music,1984,2518850,10450966,7932116
0,C.H.U.D.,88,Horror|Science Fiction,1984,2623802,7162974,4539172
0,Ghoulies,81,Comedy|Horror|Fantasy,1984,2099042,73466471,71367429
0,Best Defense,94,Action|Comedy,1984,37782756,40438678,2655922
0,Razorback,95,Horror,1984,11544731,1681332,-9863399
0,Broadway Danny Rose,84,Comedy,1984,16792336,22250888,5458552
4,Return of the Jedi,135,Adventure|Action|Science Fiction,1983,70824243,1253818981,1182994738
3,Scarface,170,Action|Crime|Drama|Thriller,1983,54732799,144242170,89509371
1,Never Say Never Again,134,Adventure|Action|Thriller,1983,78815231,350289919,271474688
1,Octopussy,131,Adventure|Action|Thriller,1983,60206079,402176614,341970535
1,Superman III,125,Comedy|Action|Adventure|Fantasy|Science Fiction,1983,85383167,165949849,80566682
1,Trading Places,116,Comedy|Drama,1983,88886067,197913804,109027737
1,WarGames,114,Thriller|Science Fiction,1983,26271743,174198448,147926705
1,National Lampoon's Vacation,98,Comedy|Adventure|Romance,1983,32839679,134422775,101583096
1,Jaws 3,99,Horror,1983,44880895,192631115,147750220
0,Sudden Impact,117,Action|Crime|Thriller,1983,48164863,148090959,99926096
0,Risky Business,98,Comedy|Romance,1983,13573734,139112774,125539040
0,The Right Stuff,193,Drama|History,1983,59111423,47070207,-12041216
0,Mickey's Christmas Carol,26,Family|Animation,1983,6567935,45975551,39407616
0,The Outsiders,91,Crime|Drama,1983,21893119,56260166,34367047
0,Porky's II: The Next Day,98,Comedy,1983,14230527,73909566,59679039
0,Yentl,132,Music|Drama|Romance,1983,26271743,66555084,40283341
0,Blue Thunder,109,Science Fiction|Action|Thriller|Crime|Drama,1983,48164863,92637133,44472270
0,The Dead Zone,103,Thriller|Horror|Science Fiction,1983,21893119,45464601,23571482
0,Flashdance,95,Drama|Music|Romance,1983,8757247,203433504,194676257
0,Twilight Zone: The Movie,101,Drama|Fantasy|Horror|Science Fiction|Thriller,1983,21893119,64477250,42584131
0,Rumble Fish,94,Action|Adventure|Crime|Drama|Romance,1983,21893119,5461194,-16431925
0,Staying Alive,93,Drama|Action|Music|Romance,1983,48164863,142070301,93905438
0,Lone Wolf McQuade,107,Action|Thriller|Drama|Western|Crime,1983,10946559,26781039,15834480
0,Psycho II,113,Horror|Mystery|Thriller,1983,10946559,76023859,65077300
0,Videodrome,87,Horror|Mystery|Science Fiction,1983,13030785,4642302,-8388483
0,Fire and Ice,81,Animation|Fantasy|Science Fiction,1983,2627174,1665810,-961364
0,Brainstorm,106,Science Fiction|Thriller,1983,32839679,22373586,-10466093
0,The Keep,96,Drama|Foreign|Horror,1983,13135871,8016728,-5119143
0,Something Wicked This Way Comes,95,Fantasy|Mystery|Thriller,1983,41596927,12382939,-29213988
0,The House on Sorority Row,91,Horror|Mystery|Thriller,1983,930457,23217623,22287166
0,Spacehunter: Adventures in the Forbidden Zone,90,Adventure|Science Fiction,1983,32839679,36123647,3283968
4,Se7en,127,Crime|Mystery|Thriller,1995,47221906,468372425,421150519
4,Toy Story,81,Animation|Comedy|Family,1995,42929006,517950958,475021952
3,The Usual Suspects,106,Drama|Crime|Thriller,1995,8585801,33401010,24815209
2,Braveheart,177,Action|Drama|History|War,1995,103029614,300503042,197473428
2,GoldenEye,130,Adventure|Action|Thriller,1995,82996078,503977993,420981915
2,Jumanji,104,Adventure|Fantasy|Family,1995,93012846,376054156,283041310
2,Die Hard: With a Vengeance,128,Action|Thriller,1995,128787018,523879354,395092336
2,Species,108,Science Fiction|Horror|Action,1995,50083840,161699256,111615416
2,Twelve Monkeys,129,Science Fiction|Thriller|Mystery,1995,42213522,241604445,199390923
2,Apollo 13,140,Drama,1995,74410277,508333712,433923435
1,Bad Boys,118,Adventure|Drama|Action|Comedy|Thriller,1995,27188370,202348766,175160396
1,Pocahontas,81,Adventure|Animation|Drama|Family,1995,78703177,495228688,416525511
1,Heat,171,Action|Crime|Drama|Thriller,1995,85858012,268215876,182357864
1,Before Sunrise,105,Drama|Romance,1995,3577417,7920981,4343564
1,Judge Dredd,96,Science Fiction,1995,128787018,162405410,33618392
1,Batman Forever,121,Science Fiction|Fantasy|Action|Crime,1995,143096686,481562054,338465368
1,Casino,178,Drama|Crime,1995,74410277,166152961,91742684
1,Babe,89,Fantasy|Drama|Comedy|Family,1995,42929006,363658636,320729630
1,Casper,100,Fantasy|Comedy|Family,1995,71548343,412015705,340467362
1,Four Rooms,98,Comedy,1995,5723867,6153157,429290
1,Waterworld,135,Adventure|Action,1995,250419201,378087518,127668317
1,Ace Ventura: When Nature Calls,90,Comedy,1995,42929006,303916660,260987654
1,The Bridges of Madison County,135,Drama|Romance,1995,34343204,260459748,226116544
1,Leaving Las Vegas,112,Drama|Romance,1995,5151480,71262149,66110669
1,The Net,114,Crime|Drama|Mystery|Thriller|Action,1995,31481271,1583049536,1551568265
1,Johnny Mnemonic,97,Adventure|Action|Drama|Science Fiction|Thriller,1995,37205138,27296723,-9908415
1,Desperado,104,Thriller|Action|Crime,1995,10016768,36354350,26337582
1,While You Were Sleeping,103,Comedy|Drama|Romance,1995,24326436,260517557,236191121
1,To Die For,106,Fantasy|Drama|Comedy|Thriller,1995,28619337,30457434,1838097
0,Under Siege 2: Dark Territory,100,Action|Thriller,1995,85858012,149284306,63426294
0,Cutthroat Island,119,Action|Adventure,1995,140234753,26497674,-113737079
0,Mortal Kombat,101,Action|Fantasy,1995,25757403,174858312,149100909
0,Sense and Sensibility,136,Drama|Romance,1995,23610953,193180527,169569574
0,Billy Madison,89,Comedy,1995,14309668,37904500,23594832
0,Mighty Morphin Power Rangers: The Movie,92,Action|Adventure|Science Fiction|Family|Fantasy,1995,21464503,94443813,72979310
0,Get Shorty,105,Comedy|Thriller|Crime,1995,43286747,164706607,121419860
0,Assassins,132,Action|Adventure|Crime|Thriller,1995,71548343,43362692,-28185651
0,The Quick and the Dead,107,Action|Adventure|Drama|Thriller|Western,1995,45790939,26547955,-19242984
0,Tank Girl,98,Action|Fantasy|Comedy|Science Fiction,1995,35774171,9444381,-26329790
0,Friday,91,Comedy|Drama,1995,5008384,40376043,35367659
0,Dead Man Walking,122,Drama,1995,15740635,56328057,40587422
0,Crimson Tide,116,Action|Thriller|Drama,1995,75841243,225215861,149374618
0,Showgirls,128,Drama,1995,64393509,29121254,-35272255
0,Mighty Aphrodite,95,Comedy|Romance,1995,21464503,9587478,-11877025
0,A Walk in the Clouds,103,Drama|Romance,1995,28619337,71566240,42946903
0,Virtuosity,106,Action|Crime|Science Fiction|Thriller,1995,42929006,34411891,-8517115
0,The Prophecy,98,Fantasy|Horror|Thriller,1995,11,22,11
0,Money Train,103,Action|Comedy|Crime,1995,85858012,50700748,-35157264
0,Rob Roy,139,Adventure,1995,40067072,45214132,5147060
0,Hackers,107,Action|Crime|Thriller|Drama,1995,28619337,10823444,-17795893
0,Nixon,192,History|Drama,1995,62962542,19578152,-43384390
0,First Knight,134,Action|Adventure|Drama|Romance,1995,78703177,182591994,103888817
0,Boys on the Side,115,Comedy|Drama,1995,30050304,33556173,3505869
0,Halloween: The Curse of Michael Myers,88,Horror|Thriller,1995,7154834,21631402,14476568
0,Fair Game,91,Action|Thriller|Romance,1995,71548343,16505454,-55042889
0,Mallrats,94,Romance|Comedy,1995,8585801,2,-8585799
0,The American President,106,Comedy|Drama|Romance,1995,88719945,154371984,65652039
0,Canadian Bacon,91,Action|Comedy,1995,15740635,254860,-15485775
0,Strange Days,145,Crime|Drama|Science Fiction|Thriller,1995,60100608,11389481,-48711127
0,Living in Oblivion,89,Drama|Comedy,1995,715483,1643826,928343
0,Nick of Time,90,Crime|Drama|Thriller,1995,11690087,11698649,8562
0,Smoke,112,Comedy|Drama,1995,10016768,11947757,1930989
0,Screamers,108,Horror|Science Fiction,1995,28619337,8273685,-20345652
0,Kids,91,Drama|Crime,1995,2146450,10606635,8460185
0,Losing Isaiah,106,Drama,1995,24326436,10880737,-13445699
0,Jade,95,Action|Thriller|Mystery|Romance,1995,71548343,14097327,-57451016
0,Vampire in Brooklyn,100,Comedy|Horror|Romance,1995,20033536,28333143,8299607
0,Sudden Death,106,Action|Adventure|Thriller,1995,50083840,92082962,41999122
0,Things to Do in Denver When You're Dead,116,Drama|Crime,1995,11447734,758077,-10689657
0,Congo,109,Action|Adventure|Drama|Mystery|Science Fiction,1995,71548343,217506963,145958620
0,The Scarlet Letter,135,Drama|History|Romance,1995,71548343,14856880,-56691463
0,Devil in a Blue Dress,102,Drama|Mystery|Thriller,1995,38636105,23096981,-15539124
0,Now and Then,100,Comedy|Drama|Family,1995,17171602,39208492,22036890
0,Waiting to Exhale,127,Comedy|Drama|Romance,1995,22895469,116555336,93659867
0,Le Hussard sur le toit,135,War|Adventure|Drama|Romance,1995,50083840,21464503,-28619337
0,How To Make An American Quilt,116,Drama|Romance,1995,14309668,33733798,19424130
0,The Pebble and the Penguin,74,Animation|Adventure|Family,1995,40067072,5700846,-34366226
0,Never Talk to Strangers,86,Thriller|Romance,1995,9158187,8,-9158179
0,Clockers,128,Mystery|Crime|Drama,1995,35774171,18704909,-17069262
0,Tales from the Hood,98,Horror|Thriller,1995,8,15,7
0,Top Dog,86,Action|Adventure|Comedy|Family|Thriller,1995,8585801,7288925,-1296876
4,Reservoir Dogs,99,Crime|Thriller,1992,1864829,22783560,20918731
3,Aladdin,90,Animation|Family|Comedy|Adventure|Fantasy,1992,43512679,783306265,739793586
3,Home Alone 2: Lost In New York,120,Comedy|Family|Adventure|Crime,1992,27972436,557881779,529909343
2,Batman Returns,126,Action|Crime|Fantasy|Science Fiction|Thriller,1992,124321940,435126791,310804851
1,AlienÂ³,114,Science Fiction|Action|Horror,1992,77701212,248291964,170590752
1,Lethal Weapon 3,118,Adventure|Action|Comedy|Thriller|Crime,1992,54390848,499978596,445587748
1,Dracula,128,Romance|Horror,1992,62160970,335455859,273294889
1,Under Siege,103,Action|Thriller,1992,54390848,243302915,188912067
1,A Few Good Men,138,Drama|Thriller,1992,62160970,378001136,315840166
1,Wayne's World,94,Comedy,1992,31080485,189120591,158040106
1,Basic Instinct,127,Thriller|Mystery,1992,76147188,548457466,472310278
0,Glengarry Glen Ross,100,Crime|Drama|Mystery,1992,19425303,16667264,-2758039
0,Honey I Blew Up the Kid,89,Adventure|Comedy|Family|Science Fiction,1992,62160970,91162873,29001903
0,Bad Lieutenant,96,Crime|Drama,1992,1554024,3138303,1584279
0,Unforgiven,131,Western,1992,21756339,247334532,225578193
0,Sister Act,100,Music|Comedy,1992,48174751,359920020,311745269
0,1492: Conquest of Paradise,154,Action|Adventure|Drama|History,1992,73039139,11175608,-61863531
0,Pet Sematary II,100,Horror,1992,12432194,26562086,14129892
0,Scent of a Woman,157,Drama,1992,48174751,208387275,160212524
0,Passenger 57,84,Action|Adventure|Thriller,1992,23310363,68479093,45168730
0,Braindead,104,Horror|Comedy,1992,4662072,377042,-4285030
0,Fortress,95,Action|Thriller|Science Fiction,1992,12432194,10472788,-1959406
0,The Bodyguard,129,Thriller|Action|Drama|Music|Romance,1992,38850606,638714442,599863836
0,Patriot Games,117,Drama|Action|Thriller|Crime,1992,69931091,276696484,206765393
0,The Mighty Ducks,101,Comedy|Family,1992,15540242,78870362,63330120
0,Twin Peaks: Fire Walk with Me,125,Drama|Mystery,1992,15540242,6466063,-9074179
0,The Player,124,Comedy|Drama,1992,12432194,33731807,21299613
0,Hellraiser III: Hell on Earth,93,Horror|Thriller|War,1992,7770121,19479633,11709512
0,Malcolm X,202,Drama|History,1992,52836824,74857205,22020381
0,The Last of the Mohicans,112,Action|Adventure|Drama|History|Romance,1992,62160970,117337931,55176961
0,El Mariachi,81,Action|Crime|Thriller,1992,341885,3171639,2829754
0,The Hand that Rocks the Cradle,110,Drama|Thriller,1992,18182083,136811140,118629057
0,Bitter Moon,139,Thriller|Drama|Romance,1992,7770121,2894844,-4875277
0,City of Joy,132,Drama,1992,41958654,22819169,-19139485
0,A League of Their Own,128,Comedy|Drama|Family,1992,62160970,166993558,104832588
0,My Cousin Vinny,120,Comedy|Drama,1992,17094266,99595164,82500898
0,The Crying Game,112,Romance|Crime|Drama|Thriller,1992,5758495,97202580,91444085
0,Boomerang,117,Drama|Comedy|Romance,1992,62160970,108937100,46776130
0,The Lawnmower Man,108,Horror|Thriller|Science Fiction,1992,15540242,49885732,34345490
0,Candyman,99,Drama|Horror|Thriller,1992,9324145,40081875,30757730
0,Unlawful Entry,117,Crime|Thriller,1992,35742557,88794955,53052398
0,Captain Ron,100,Action|Adventure|Comedy|Family,1992,37296582,34993668,-2302914
0,Memoirs of an Invisible Man,99,Action|Comedy|Drama|Fantasy|Science Fiction,1992,62160970,22312731,-39848239
0,Rapid Fire,95,Action|Thriller,1992,15540242,22310316,6770074
0,Far and Away,140,Adventure|Drama|Romance|Western,1992,93241455,214119429,120877974
0,Radio Flyer,114,Drama,1992,54390848,7229285,-47161563
0,Juice,96,Action|Crime|Drama|Thriller,1992,7770121,31308740,23538619
0,Seong lung wui,89,Action|Comedy|Foreign,1992,15540242,12991202,-2549040
0,Single White Female,107,Thriller,1992,24864388,74620207,49755819
0,Jennifer Eight,124,Crime|Drama|Mystery,1992,31080485,17701080,-13379405
0,Diggstown,98,Action|Comedy|Drama,1992,26418412,7516251,-18902161
0,Raising Cain,91,Drama|Horror|Thriller|Crime,1992,18648291,57763170,39114879
0,Strictly Ballroom,94,Comedy|Drama|Romance,1992,4662072,52753255,48091183
4,Raiders of the Lost Ark,115,Adventure|Action,1981,43167434,935116878,891949444
1,Private Lessons,87,Romance|Comedy,1981,6714934,63022056,56307122
1,For Your Eyes Only,127,Adventure|Action|Thriller,1981,67149342,468397365,401248023
1,The Fox and the Hound,82,Adventure|Animation|Drama|Family,1981,28778289,71466085,42687796
1,Mad Max 2,95,Adventure|Action|Thriller|Science Fiction,1981,4796381,58997489,54201108
1,History of the World: Part I,92,Comedy,1981,26380098,75957674,49577576
1,An American Werewolf in London,97,Horror|Comedy,1981,23981908,76677951,52696043
1,The Evil Dead,85,Horror,1981,839366,70506809,69667443
1,Escape from New York,99,Science Fiction|Action,1981,14389144,119909540,105520396
0,Chariots of Fire,123,Drama|History,1981,13190049,141428276,128238227
0,Friday the 13th Part 2,87,Horror|Thriller,1981,2997738,52095361,49097623
0,Halloween II,92,Horror|Thriller,1981,5995477,61234967,55239490
0,Arthur,97,Comedy|Drama|Romance,1981,16787335,228935328,212147993
0,Road Games,101,Thriller|Horror|Mystery,1981,4196833,239819,-3957014
0,Porky's,94,Comedy,1981,9592763,301520352,291927589
0,Reds,195,Drama|History,1981,76742105,96845321,20103216
0,The Cannonball Run,95,Comedy,1981,43167434,173100402,129932968
0,Absence of Malice,116,Drama|Romance|Thriller,1981,28778289,97647046,68868757
0,Time Bandits,116,Family|Fantasy|Science Fiction|Adventure|Comedy,1981,11990954,101600746,89609792
0,Scanners,103,Horror|Science Fiction|Thriller,1981,9832582,34116365,24283783
0,Stripes,106,Action|Comedy,1981,23981908,204565675,180583767
0,Outland,112,Science Fiction,1981,38371052,41667593,3296541
0,Dead & Buried,94,Horror|Mystery,1981,7194572,518407,-6676165
0,Blow Out,108,Drama|Mystery|Thriller,1981,43167434,28778289,-14389145
0,Dragonslayer,108,Fantasy,1981,43167434,14389144,-28778290
0,The Howling,91,Drama|Horror,1981,2398190,43133603,40735413
0,Nighthawks,99,Action|Crime|Thriller,1981,11990954,47736848,35745894
0,Taps,126,Drama,1981,33574671,85989656,52414985
0,Clash of the Titans,118,Adventure|Fantasy|Family,1981,35972862,98547243,62574381
0,Neighbors,94,Comedy,1981,20384621,71744772,51360151
4,Independence Day,145,Action|Adventure|Science Fiction,1996,104266255,1135764352,1031498097
3,Mission: Impossible,110,Adventure|Action|Thriller,1996,111217339,636297139,525079800
2,Trainspotting,93,Drama|Crime,1996,5560866,22926175,17365309
2,Fargo,98,Crime|Drama|Thriller,1996,9731517,84263782,74532265
2,The Rock,136,Action|Adventure|Thriller,1996,104266255,465809664,361543409
2,Mars Attacks!,106,Comedy|Fantasy|Science Fiction,1996,97315171,140927684,43612513
1,Romeo + Juliet,120,Drama|Romance,1996,20158142,204777203,184619061
1,The Hunchback of Notre Dame,91,Family|Fantasy|Animation,1996,139021673,139214706,193033
1,Space Jam,88,Animation|Comedy|Drama|Family|Fantasy,1996,111217339,319749850,208532511
1,Eraser,115,Action|Drama|Mystery|Thriller,1996,139021673,336843346,197821673
1,101 Dalmatians,103,Comedy|Family,1996,75071703,445827624,370755921
1,Phenomenon,123,Drama|Fantasy|Romance|Science Fiction,1996,44486935,211363523,166876588
1,From Dusk Till Dawn,108,Horror|Action|Thriller|Crime,1996,26414118,35918496,9504378
1,A Time to Kill,149,Crime|Drama|Thriller,1996,55608669,211682751,156074082
1,Star Trek: First Contact,111,Science Fiction|Action|Adventure|Thriller,1996,63949969,208532510,144582541
1,Happy Gilmore,92,Comedy,1996,16682600,57284018,40601418
1,Jingle All the Way,89,Comedy|Family,1996,83413004,180495160,97082156
1,Scream,111,Crime|Horror|Mystery,1996,19463034,240572367,221109333
1,The Long Kiss Goodnight,120,Action|Crime|Drama|Mystery|Thriller,1996,90364088,124364286,34000198
1,Jerry Maguire,139,Comedy|Drama|Romance,1996,69510836,380297392,310786556
1,Matilda,98,Comedy|Family|Fantasy,1996,50047802,46515840,-3531962
1,DragonHeart,103,Fantasy,1996,79242354,160246634,81004280
1,The Nutty Professor,95,Fantasy|Comedy|Romance|Science Fiction,1996,75071703,179017298,103945595
1,Daylight,115,Action|Adventure|Thriller,1996,111217339,221339839,110122500
1,The Quest,95,Action|Adventure,1996,41706502,79799201,38092699
1,Chain Reaction,107,Adventure,1996,69510836,83704023,14193187
1,The English Patient,162,Drama|Romance|War,1996,37535851,322497509,284961658
1,Executive Decision,133,Action|Adventure|Drama|Thriller,1996,76461920,169563645,93101725
0,Twister,113,Action|Adventure|Drama,1996,127899940,687422589,559522649
0,Ransom,117,Action|Thriller,1996,111217339,430261905,319044566
0,The Cable Guy,96,Comedy|Drama|Thriller,1996,65340186,142950142,77609956
0,Sleepers,147,Crime|Drama|Thriller,1996,61169536,230241141,169071605
0,The Frighteners,110,Horror|Comedy,1996,41706502,40815673,-890829
0,Broken Arrow,108,Action|Adventure|Drama|Thriller,1996,69510836,208908073,139397237
0,Escape from L.A.,97,Action|Adventure|Science Fiction|Thriller,1996,69510836,58774700,-10736136
0,The People vs. Larry Flynt,129,Drama,1996,50047802,28221935,-21825867
0,The Arrival,115,Action|Mystery|Science Fiction|Thriller,1996,34755418,19530281,-15225137
0,Bound,108,Romance|Drama|Thriller|Crime,1996,6255975,9747250,3491275
0,Swingers,94,Comedy|Romance,1996,278043,6264208,5986165
0,Striptease,115,Drama|Thriller|Crime,1996,69510836,157525101,88014265
0,The Fan,116,Drama|Mystery|Thriller,1996,76461920,25894759,-50567161
0,Jack,113,Comedy|Drama|Science Fiction,1996,62559753,81495857,18936104
0,Primal Fear,129,Crime|Drama|Mystery|Thriller,1996,41706502,142658735,100952233
0,Courage Under Fire,117,Drama|Thriller|Mystery|War,1996,63949969,140218397,76268428
0,Set  It Off,118,Drama|Action|Crime,1996,12511950,57820345,45308395
0,The Craft,101,Fantasy|Drama|Horror|Thriller,1996,20853251,34434926,13581675
0,Hellraiser: Bloodline,86,Horror|Thriller|Science Fiction,1996,5560866,23181864,17620998
0,Kingpin,113,Comedy,1996,37535851,34787996,-2747855
0,The Preacher's Wife,124,Fantasy|Drama|Comedy|Science Fiction|Romance,1996,55608669,66859986,11251317
0,Bulletproof,84,Action|Adventure|Comedy|Thriller,1996,34755418,31435516,-3319902
0,Bordello of Blood,87,Horror|Comedy,1996,20853251,6,-20853245
0,Evita,134,History|Drama|Music,1996,76461920,196086149,119624229
0,Flirting with Disaster,92,Comedy|Romance,1996,9731517,20439575,10708058
0,Basquiat,108,Drama|History,1996,4117892,4186213,68321
0,Last Man Standing,101,Action|Crime|Drama|Thriller,1996,93144521,65711375,-27433146
0,Maximum Risk,100,Action|Adventure|Thriller,1996,34755418,71877657,37122239
0,Fled,98,Action|Comedy|Thriller,1996,34755418,23902317,-10853101
0,She's the One,96,Comedy|Romance,1996,4865758,13182840,8317082
0,The Crow: City of Angels,84,Action|Fantasy|Thriller,1996,18072817,24908912,6836095
0,Bottle Rocket,91,Comedy|Crime|Drama,1996,9731517,778617,-8952900
0,James and the Giant Peach,79,Adventure|Animation|Family,1996,52828236,40206825,-12621411
0,Emma,121,Comedy|Drama|Romance,1996,8341300,30906823,22565523
0,Tin Cup,135,Comedy|Drama|Romance,1996,62559753,74869549,12309796
0,The First Wives Club,103,Comedy,1996,36145635,161821228,125675593
0,Kama Sutra - A Tale of Love,117,Drama|History|Romance,1996,4170650,5712532,1541882
0,Sling Blade,135,Drama,1996,1390216,34026133,32635917
0,Secrets & Lies,142,Drama,1996,6255975,18652943,12396968
0,Mary Reilly,104,Drama|Horror|Thriller|Romance,1996,65340186,17210051,-48130135
0,The Ghost and the Darkness,109,Adventure,1996,69510836,104266255,34755419
0,Jude,123,Drama|Romance,1996,9731517,563037,-9168480
0,Lone Star,135,Drama|Mystery|Romance,1996,6951083,18448124,11497041
0,Flipper,95,Adventure|Family,1996,35492233,27915579,-7576654
0,The Chamber,113,Drama|Thriller,1996,69510836,31335984,-38174852
0,White Squall,129,Action|Drama,1996,52828236,14319232,-38509004
0,The Phantom,100,Adventure|Action,1996,62559753,24051985,-38507768
0,Extreme Measures,118,Drama|Thriller,1996,52828236,24162142,-28666094
0,Michael Collins,132,Drama|Thriller,1996,38926068,23494662,-15431406
0,Hard Eight,96,Drama|Thriller,1996,4170650,309405,-3861245
0,Doctor Who,89,TV Movie|Adventure|Drama|Science Fiction,1996,6951083,58389103,51438020
0,Ridicule,102,Comedy|Drama|Romance,1996,4170650,3480864,-689786
0,The Island of Dr. Moreau,96,Fantasy|Horror|Science Fiction,1996,55608669,68993369,13384700
0,Silent Trigger,93,Drama|Action|Thriller,1996,20853251,106187,-20747064
0,Citizen Ruth,104,Drama|Comedy,1996,4170650,212918,-3957732
0,Joe's Apartment,78,Fantasy|Comedy|Music,1996,18072817,6421430,-11651387
0,Bad Moon,80,Horror,1996,9731517,1529238,-8202279
0,Mrs. Winterbourne,105,Comedy|Romance|Drama,1996,34755418,13999482,-20755936
4,Gladiator,155,Action|Drama|Adventure,2000,130428087,579506463,449078376
3,Memento,113,Mystery|Thriller,2000,11396629,50301043,38904414
2,How the Grinch Stole Christmas,104,Family|Comedy|Fantasy,2000,155753930,437049837,281295907
2,Cast Away,143,Adventure|Drama,2000,113966290,544039793,430073503
2,Snatch,103,Thriller|Crime,2000,12662921,105808674,93145753
1,Mission: Impossible II,123,Adventure|Action|Thriller,2000,158286514,691886948,533600434
1,Bedazzled,93,Fantasy|Comedy|Romance,2000,60782021,114451543,53669522
1,Scary Movie,88,Comedy,2000,24059550,352054243,327994693
1,The Emperor's New Groove,78,Adventure|Animation|Comedy|Family|Fantasy,2000,126629211,214418314,87789103
1,What Women Want,127,Comedy|Romance,2000,88640448,473734704,385094256
1,Dinosaur,82,Animation|Family,2000,161452244,448581528,287129284
1,Charlie's Angels,98,Action|Adventure|Comedy|Crime|Thriller,2000,116498874,334434769,217935895
1,Chicken Run,84,Animation|Comedy|Family,2000,56983145,284706235,227723090
1,The Patriot,165,Drama|History|War|Action,2000,139292132,272625527,133333395
1,Final Destination,98,Horror,2000,29124718,67496299,38371581
1,Coyote Ugly,100,Comedy,2000,56983145,144251532,87268387
1,Romeo Must Die,115,Action|Crime|Thriller,2000,31657302,115279131,83621829
1,U-571,116,Action|Drama|Thriller|War,2000,78510111,161662974,83152863
1,Billy Elliot,110,Drama|Comedy|Music,2000,6331460,139292132,132960672
1,Gone In Sixty Seconds,118,Action|Crime|Thriller,2000,113966290,300367400,186401110
1,Erin Brockovich,131,Drama,2000,65847189,324514308,258667119
1,Meet the Parents,108,Comedy|Romance,2000,69646066,418438688,348792622
1,"O Brother, Where Art Thou?",106,Action|Adventure|Comedy,2000,32923594,89906740,56983146
1,Pitch Black,109,Thriller|Science Fiction|Action,2000,29124718,67351113,38226395
1,Boiler Room,118,Crime|Drama|Thriller,2000,32923594,36444209,3520615
1,The Road to El Dorado,89,Adventure|Animation|Comedy|Family,2000,120297750,96786159,-23511591
1,Miss Congeniality,111,Comedy|Crime|Action,2000,56983145,268453928,211470783
1,Frequency,118,Crime|Drama|Science Fiction|Thriller,2000,39255055,86242400,46987345
1,Requiem for a Dream,102,Drama,2000,5698314,9358035,3659721
1,Pay It Forward,122,Drama|Romance,2000,50651684,70541855,19890171
1,Hollow Man,112,Action|Science Fiction|Thriller,2000,120297750,240865798,120568048
1,Big Momma's House,98,Crime|Comedy,2000,37988763,220283464,182294701
0,American Psycho,102,Thriller|Drama|Crime,2000,8864044,43391479,34527435
0,Dancer in the Dark,140,Drama|Crime|Music,2000,16208539,50692052,34483513
0,Road Trip,93,Comedy|Adventure,2000,20260673,151643897,131383224
0,Remember the Titans,113,Drama,2000,37988763,173110594,135121831
0,The Gift,111,Horror|Drama|Thriller|Mystery,2000,12662921,15206448,2543527
0,The Legend of Bagger Vance,126,Fantasy|Drama,2000,101303369,49967161,-51336208
0,Traffic,148,Drama,2000,60782021,262775526,201993505
0,"Dude, Whereâ€™s My Car?",83,Comedy,2000,16461797,92668172,76206375
0,The Family Man,125,Comedy|Drama|Romance|Fantasy,2000,75977526,157963714,81986188
0,The 6th Day,123,Action|Mystery|Science Fiction|Thriller,2000,103835953,121672281,17836328
0,The Skulls,106,Crime|Drama|Thriller,2000,18994381,44329315,25334934
0,"Me, Myself & Irene",116,Comedy,2000,64580897,189020688,124439791
0,Shanghai Noon,110,Adventure|Action|Comedy|Western,2000,69646066,72092928,2446862
0,Unbreakable,106,Action|Fantasy|Thriller,2000,94971908,314190020,219218112
0,Space Cowboys,130,Action|Adventure|Thriller,2000,82308987,163204960,80895973
0,The Whole Nine Yards,98,Comedy|Crime,2000,52297864,134697582,82399718
0,Almost Famous,122,Drama|Music,2000,75977526,60001591,-15975935
0,Bring It On,98,Comedy,2000,35456179,114536031,79079852
0,Chocolat,121,Comedy|Drama|Romance,2000,31657302,193109981,161452679
0,High Fidelity,113,Comedy|Drama|Romance|Music,2000,37988763,59675655,21686892
0,Red Planet,106,Thriller|Action|Science Fiction,2000,101303369,42375160,-58928209
0,Mission to Mars,114,Science Fiction,2000,113966290,77085044,-36881246
0,The Cell,107,Horror|Science Fiction|Thriller,2000,41787639,131891722,90104083
0,Shaft,99,Action|Adventure|Crime|Thriller,2000,58249437,135742080,77492643
0,Get Carter,102,Action|Drama|Thriller|Crime,2000,80536178,24582519,-55953659
0,The Flintstones in Viva Rock Vegas,90,Science Fiction|Comedy|Family|Romance,2000,105102245,75304207,-29798038
0,Thirteen Days,145,Drama|Thriller,2000,101303369,43771597,-57531772
0,The Beach,119,Drama|Adventure|Romance|Thriller,2000,50651684,182418082,131766398
0,The Perfect Storm,130,Drama,2000,151955053,412503060,260548007
0,Titan A.E.,94,Animation|Action|Science Fiction|Family|Adventure,2000,94971908,46542103,-48429805
0,Scream 3,116,Horror|Mystery,2000,50651684,204929467,154277783
0,Vertical Limit,124,Action|Adventure|Thriller,2000,94971908,273093444,178121536
0,Reindeer Games,124,Thriller,2000,53184268,40735313,-12448955
0,The Tigger Movie,77,Animation|Family,2000,37988763,57685345,19696582
0,Next Friday,98,Comedy,2000,13929213,75758873,61829660
0,Dracula 2000,99,Horror|Thriller,2000,35456179,41788066,6331887
0,The Weight of Water,113,Crime|Drama|Mystery,2000,20260673,138190,-20122483
0,Urban Legends: Final Cut,97,Horror,2000,17728089,48846410,31118321
0,Men of Honor,129,Drama,2000,40521347,61813934,21292587
0,What Lies Beneath,130,Drama|Horror|Mystery|Thriller,2000,126629211,196863281,70234070
0,Rules of Engagement,128,Action|Adventure|Drama|History|War,2000,75977526,89906740,13929214
0,Finding Forrester,136,Drama,2000,54450560,101366384,46915824
0,Boys and Girls,94,Comedy|Drama|Romance,2000,20260673,26120278,5859605
0,102 Dalmatians,100,Comedy|Family,2000,107634829,232506137,124871308
1,Nutty Professor II: The Klumps,106,Fantasy|Comedy|Romance|Science Fiction,2000,106368537,156143878,49775341
0,Keeping the Faith,127,Comedy,2000,37988763,46898399,8909636
0,Supernova,91,Science Fiction,2000,113966290,18776682,-95189608
0,Bounce,106,Drama|Romance,2000,44320224,46573332,2253108
0,The Art of War,117,Action|Adventure|Thriller,2000,50651684,38240888,-12410796
0,Whatever It Takes,94,Drama|Comedy|Romance,2000,18994381,12538970,-6455411
0,The Kid,104,Fantasy|Comedy|Family,2000,82308987,88260560,5951573
0,Highlander: Endgame,87,Action|Fantasy|Science Fiction,2000,31657302,20062635,-11594667
0,Love & Basketball,124,Action|Comedy|Drama|Romance,2000,25325842,35111897,9786055
0,Gossip,90,Drama|Mystery|Thriller,2000,17728089,6469258,-11258831
0,Quills,124,Drama,2000,17094943,8941131,-8153812
0,The Next Best Thing,108,Comedy|Drama,2000,31657302,30850386,-806916
0,Dungeons & Dragons,107,Action|Adventure|Fantasy|Science Fiction,2000,44320224,19228950,-25091274
0,The Ladies Man,84,Comedy,2000,30391010,17348201,-13042809
0,Hamlet,112,Drama,2000,2532584,1986494,-546090
0,Under Suspicion,110,Mystery|Thriller,2000,31657302,329947,-31327355
0,Ready to Rumble,107,Action|Comedy|Drama,2000,30391010,15667085,-14723925
0,Center Stage,115,Drama|Music,2000,22793258,21781395,-1011863
0,Return to Me,115,Romance|Comedy|Drama,2000,30391010,46358947,15967937
0,Saving Grace,93,Crime|Comedy,2000,12662921,33342081,20679160
0,The Broken Hearts Club: A Romantic Comedy,94,Comedy|Drama|Romance,2000,1266292,2209499,943207
0,Drowning Mona,96,Comedy|Crime|Mystery,2000,20260673,19535331,-725342
0,Gun Shy,101,Action|Comedy|Romance|Thriller,2000,12662921,2066384,-10596537
0,X-Men,104,Adventure|Action|Science Fiction,2000,94971908,199187391,104215483
0,The Little Vampire,95,Horror|Family|Foreign,2000,27858426,17165840,-10692586
0,Shadow of the Vampire,92,Drama|Horror,2000,10130336,10483653,353317
0,The Adventures of Rocky & Bullwinkle,88,Adventure|Animation|Action|Comedy|Family,2000,96238200,44490945,-51747255
0,The Big Kahuna,90,Comedy|Drama,2000,8864044,4721861,-4142183
0,Hanging Up,94,Comedy|Drama,2000,50651684,45634519,-5017165
0,The In Crowd,105,Thriller,2000,18994381,6606876,-12387505
4,Blade Runner,117,Science Fiction|Drama|Thriller,1982,63269987,74045476,10775489
2,E.T. the Extra-Terrestrial,115,Science Fiction|Adventure|Family|Fantasy,1982,23726245,1791694309,1767968064
2,The Thing,109,Horror|Science Fiction|Mystery|Thriller,1982,22596424,31144285,8547861
1,First Blood,93,Action|Adventure|Thriller|War,1982,33894636,282936387,249041751
1,Tron,96,Science Fiction|Action|Adventure,1982,38413920,74568199,36154279
1,Rocky III,99,Drama,1982,38413920,280195657,241781737
1,Poltergeist,114,Horror,1982,24178173,276128301,251950128
1,Conan the Barbarian,129,Adventure|Fantasy|Action,1982,45192848,155579712,110386864
1,48 Hrs.,96,Thriller|Action|Comedy|Crime|Drama,1982,2259642,178214624,175954982
0,Star Trek II: The Wrath of Khan,113,Science Fiction|Action|Adventure|Drama|Thriller,1982,27115708,218733384,191617676
0,Fast Times at Ridgemont High,90,Comedy,1982,10168390,61220220,51051830
0,The Dark Crystal,93,Fantasy,1982,33894636,91689512,57794876
0,Gandhi,191,Drama|History,1982,49712132,175659830,125947698
0,Tootsie,116,Comedy|Romance,1982,47452490,400408633,352956143
0,The Secret of NIMH,82,Fantasy|Animation|Drama|Family,1982,15817496,33139312,17321816
0,Sophie's Choice,151,Drama|Romance,1982,27115708,67870619,40754911
0,Grease 2,115,Comedy|Drama|Family|Music|Romance,1982,29827279,34282110,4454831
0,Creepshow,120,Horror|Comedy|Fantasy,1982,18077139,47517466,29440327
0,Annie,127,Comedy|Drama|Family|Music,1982,112982120,128932942,15950822
0,The Year of Living Dangerously,115,War|Drama|Romance,1982,13557854,23225903,9668049
0,Friday the 13th Part III,95,Horror|Thriller,1982,9038569,82906431,73867862
0,Halloween III: Season of the Witch,96,Horror|Mystery|Science Fiction,1982,5649106,32538850,26889744
0,The Verdict,129,Drama,1982,36154278,121969282,85815004
0,Firefox,136,Science Fiction|Action|Adventure|Thriller,1982,40673563,159728119,119054556
0,Death Wish 2,88,Action|Crime|Thriller,1982,4,36,32
0,The Man from Snowy River,104,Drama|Action|Western|Romance,1982,7908748,46682908,38774160
4,The Truman Show,103,Comedy|Drama,1998,80261728,353309720,273047992
2,Armageddon,151,Action|Thriller|Science Fiction|Adventure,1998,187277365,740815170,553537805
2,Mulan,88,Animation|Family|Adventure,1998,120392592,407087824,286695232
2,Blade,120,Horror|Action,1998,60196296,175483613,115287317
2,The Big Lebowski,117,Comedy|Crime,1998,20065432,37106552,17041120
2,Saving Private Ryan,169,Drama|History|War,1998,93638682,644556400,550917718
2,Rush Hour,98,Action|Comedy|Crime|Thriller,1998,44143950,326915200,282771250
2,A Bug's Life,95,Family|Animation,1998,160523456,486116613,325593157
1,The Prince of Egypt,99,Adventure|Animation|Drama|Family|Music,1998,93638682,292437871,198799189
1,Antz,83,Adventure|Animation|Comedy|Family,1998,80261728,229759715,149497987
1,Ronin,122,Action|Thriller|Crime|Adventure,1998,73573250,55662690,-17910560
1,Dark City,100,Mystery|Science Fiction,1998,36117777,36385739,267962
1,Wild Things,108,Crime|Drama|Mystery,1998,26753909,89893135,63139226
1,There's Something About Mary,119,Romance|Comedy,1998,30766995,494793021,464026026
1,The X Files,121,Mystery|Science Fiction|Thriller,1998,88287900,253089726,164801826
1,American History X,119,Drama,1998,26753909,31937649,5183740
1,What Dreams May Come,113,Drama|Fantasy|Romance,1998,113704114,95625218,-18078896
1,Enemy of the State,132,Action|Drama|Thriller,1998,120392592,335293149,214900557
1,Deep Impact,120,Action|Adventure|Drama|Romance|Science Fiction,1998,100327160,187898944,87571784
1,Lost in Space,130,Adventure|Family|Science Fiction,1998,107015637,182139843,75124206
1,The Negotiator,140,Action|Adventure|Crime|Drama|Mystery,1998,66884773,59591231,-7293542
1,Meet Joe Black,178,Fantasy|Drama|Mystery,1998,120392592,191210324,70817732
1,Lethal Weapon 4,127,Action|Adventure|Comedy|Crime|Drama,1998,187277365,381837952,194560587
1,I Still Know What You Did Last Summer,100,Horror|Mystery|Thriller,1998,86950205,53510643,-33439562
1,Godzilla,139,Science Fiction|Action|Thriller,1998,173900411,507005703,333105292
1,Practical Magic,104,Drama|Fantasy|Comedy,1998,100327160,62448141,-37879019
1,Sphere,134,Science Fiction,1998,100327160,17523810,-82803350
1,Six Days Seven Nights,98,Action|Adventure|Comedy|Romance,1998,93638682,219382056,125743374
1,Fear and Loathing in Las Vegas,118,Adventure|Drama|Comedy,1998,24747366,14286955,-10460411
1,Shakespeare in Love,122,History,1998,33442386,387019102,353576716
1,The Mask of Zorro,136,Adventure|Comedy|Western|Romance|Thriller,1998,127081069,334809823,207728754
1,The Waterboy,90,Comedy,1998,30766995,248800182,218033187
1,A Perfect Murder,107,Crime|Thriller|Drama,1998,80261728,171276344,91014616
1,Pi,84,Mystery|Drama|Thriller,1998,80261,4308920,4228659
1,City of Angels,114,Drama|Fantasy|Romance,1998,73573250,265780176,192206926
0,The Thin Red Line,170,Drama|History|War,1998,69560164,131263461,61703297
0,Small Soldiers,110,Comedy|Adventure|Fantasy|Science Fiction|Action,1998,53507818,73148595,19640777
0,Doctor Dolittle,85,Comedy|Family|Fantasy,1998,94976378,393893266,298916888
0,Star Trek: Insurrection,103,Science Fiction|Action|Adventure|Thriller,1998,93638682,157848065,64209383
0,You've Got Mail,119,Comedy|Romance,1998,86950205,335522777,248572572
0,U.S. Marshals,131,Thriller|Crime|Action,1998,80261728,136936413,56674685
0,Elizabeth,124,Drama|History,1998,40130864,109892541,69761677
0,Out of Sight,123,Romance|Comedy|Crime,1998,64209382,103999894,39790512
0,The Wedding Singer,95,Romance|Comedy,1998,24078518,164947197,140868679
0,EverAfter,121,Drama|Romance|Comedy,1998,34780082,87894313,53114231
0,Patch Adams,115,Comedy|Drama,1998,66884773,270606298,203721525
0,Urban Legend,99,Horror|Thriller,1998,18727736,97019835,78292099
0,Rounders,121,Drama|Crime,1998,16052345,30662519,14610174
0,Disturbing Behavior,82,Horror|Thriller|Science Fiction,1998,20065432,23419526,3354094
0,Babe: Pig in the City,92,Adventure|Comedy|Drama|Family|Fantasy,1998,120392592,92477375,-27915217
0,"Lock, Stock and Two Smoking Barrels",105,Comedy|Crime,1998,1805888,5213760,3407872
0,A Night at the Roxbury,81,Comedy,1998,22740822,40573861,17833039
0,The Horse Whisperer,170,Drama|Romance,1998,80261728,249993295,169731567
0,Bride of Chucky,89,Comedy|Horror,1998,33442386,67783504,34341118
0,54,93,Music|Drama,1998,17390041,22415981,5025940
0,Great Expectations,111,Comedy|Drama|Romance,1998,33442386,74234160,40791774
0,The Siege,116,Drama|Action|Thriller|Crime,1998,93638682,156072825,62434143
0,Snake Eyes,98,Crime|Mystery,1998,97651769,138975067,41323298
0,Sliding Doors,99,Comedy|Drama|Fantasy|Romance,1998,8026172,77586337,69560165
0,The Avengers,89,Thriller,1998,80261728,64908772,-15352956
0,Simon Birch,114,Comedy|Drama|Family,1998,26753909,24417510,-2336399
0,The Big Hit,91,Action|Adventure|Comedy|Thriller,1998,17390041,36127332,18737291
0,Blues Brothers 2000,123,Music|Action|Comedy|Crime,1998,37455473,18796472,-18659001
0,He Got Game,136,Drama,1998,33442386,28851219,-4591167
0,Hard Rain,97,Thriller,1998,93638682,26580767,-67057915
0,A Civil Action,115,Drama,1998,93638682,75851213,-17787469
0,Happiness,139,Comedy|Drama,1998,4013086,3755432,-257654
0,The Replacement Killers,87,Drama|Action|Crime|Thriller,1998,40130864,25690346,-14440518
0,The Faculty,104,Horror|Mystery|Science Fiction,1998,20065432,53886815,33821383
0,Playing by Heart,121,Comedy|Drama|Romance,1998,26753909,5310755,-21443154
0,Can't Hardly Wait,100,Comedy|Drama|Romance,1998,13376954,34251712,20874758
0,Halloween: H20,86,Horror|Thriller,1998,22740822,73629083,50888261
0,Psycho,105,Horror|Mystery|Thriller,1998,80261728,49683521,-30578207
0,Deep Rising,106,Adventure|Action|Horror|Science Fiction,1998,60196296,14986237,-45210059
0,The Red Violin,131,Drama|Thriller|Mystery|Music|Romance,1998,24078518,12701964,-11376554
0,Very Bad Things,100,Comedy|Crime|Thriller,1998,40130864,13241060,-26889804
0,Soldier,99,Action|War|Science Fiction,1998,100327160,19487391,-80839769
0,The Opposite of Sex,105,Comedy|Drama,1998,6688477,7864651,1176174
0,Bulworth,108,Comedy|Drama,1998,40130864,39064565,-1066299
0,Buffalo '66,110,Romance|Comedy|Crime|Drama,1998,2006543,3177156,1170613
0,Half Baked,82,Comedy|Crime,1998,10701563,23356189,12654626
0,Gods and Monsters,105,Drama,1998,13376954,8630313,-4746641
0,Without Limits,117,Drama,1998,33442386,1039955,-32402431
0,Jane Austen's Mafia!,84,Comedy|Crime,1998,13376954,25416213,12039259
0,Zero Effect,116,Comedy|Crime|Mystery|Thriller,1998,6688477,2649089,-4039388
0,Six-String Samurai,91,Action|Adventure|Science Fiction,1998,2675390,166535,-2508855
0,Edge of Seventeen,99,Comedy|Drama|Romance,1998,2006543,1164799,-841744
0,Home Fries,93,Drama|Comedy|Romance,1998,20065432,13969976,-6095456
0,Strangeland,86,Horror,1998,1471465,844381,-627084
0,The Object of My Affection,111,Comedy|Drama|Romance,1998,20065432,62745795,42680363
0,The Newton Boys,113,Crime|Action|Drama,1998,36117777,101664855,65547078
0,How Stella Got Her Groove Back,124,Comedy|Drama|Romance,1998,26753909,50394131,23640222
4,The Little Mermaid,83,Animation|Family,1989,70359397,371749996,301390599
3,Indiana Jones and the Last Crusade,127,Adventure|Action,1989,84431277,834061065,749629788
2,When Harry Met Sally...,96,Comedy|Romance|Drama,1989,28143759,163275219,135131460
2,Batman,126,Fantasy|Action,1989,61564472,723556562,661992090
2,Back to the Future Part II,108,Adventure|Comedy|Family|Science Fiction|Action,1989,70359397,583982999,513623602
2,Dead Poets Society,129,Drama,1989,28847353,414874391,386027038
2,Ghostbusters II,108,Fantasy|Action|Comedy|Science Fiction|Family,1989,65082442,378876100,313793658
2,Licence to Kill,133,Adventure|Action|Thriller,1989,56287518,274695427,218407909
1,National Lampoon's Christmas Vacation,97,Comedy,1989,47492593,125450805,77958212
1,Glory,122,War,1989,31661728,47190689,15528961
1,The Abyss,139,Adventure|Action|Thriller|Science Fiction,1989,123128945,158308816,35179871
1,Lethal Weapon 2,114,Action|Adventure|Comedy|Crime|Thriller,1989,43974623,400791729,356817106
1,Tango & Cash,104,Action|Adventure|Comedy,1989,96744171,111534797,14790626
1,Bill & Ted's Excellent Adventure,90,Adventure|Comedy|Science Fiction,1989,17589849,71212573,53622724
1,Look Who's Talking,93,Comedy|Romance,1989,13192387,520659542,507467155
1,"Honey, I Shrunk the Kids",93,Adventure|Comedy|Family|Science Fiction,1989,56287518,391768464,335480946
1,Star Trek V: The Final Frontier,107,Science Fiction|Action|Adventure|Thriller,1989,52769548,123480742,70711194
0,Kickboxer,97,Action|Thriller,1989,2638477,25851810,23213333
0,A Nightmare on Elm Street 5: The Dream Child,89,Horror|Thriller,1989,14071879,38993809,24921930
0,Cyborg,86,Action|Science Fiction,1989,879492,17882648,17003156
0,The 'Burbs,101,Comedy|Horror|Thriller,1989,31661728,64382366,32720638
0,Pet Sematary,103,Drama|Horror,1989,20228326,101087926,80859600
0,"See No Evil, Hear No Evil",103,Crime|Comedy,1989,31661728,82512201,50850473
0,Born on the Fourth of July,145,Drama|War,1989,24625789,283199561,258573772
0,Uncle Buck,100,Comedy|Drama|Family,1989,26384774,139414574,113029800
0,Major League,107,Comedy,1989,19348834,87592433,68243599
0,Weekend at Bernie's,97,Comedy,1989,11433402,53153687,41720285
0,K-9,101,Action|Adventure|Comedy|Crime,1989,32714340,137636432,104922092
0,Casualties of War,113,Drama|History|War,1989,39577161,32842565,-6734596
0,Friday the 13th Part VIII: Jason Takes Manhattan,100,Horror|Thriller,1989,8794924,24625789,15830865
0,Always,122,Fantasy|Drama|Romance,1989,54528533,130401979,75873446
0,Miracle Mile,87,Science Fiction|Thriller,1989,5276954,2014748,-3262206
0,All Dogs Go to Heaven,89,Drama|Animation|Family|Comedy|Fantasy,1989,24273992,47668539,23394547
0,Harlem Nights,116,Action|Comedy|Crime|Drama|Thriller,1989,52769548,107060389,54290841
0,Sea of Love,113,Drama|Crime|Mystery,1989,33420713,195035393,161614680
0,Dead Calm,96,Crime|Thriller|Horror|Drama,1989,17589849,13764057,-3825792
0,Shocker,109,Thriller|Comedy|Horror,1989,8794924,29119466,20324542
0,Driving Miss Daisy,99,Comedy|Drama,1989,13192387,256448211,243255824
0,Crimes and Misdemeanors,104,Comedy|Drama,1989,33420713,32109745,-1310968
0,Black Rain,125,Action|Thriller|Crime,1989,52769548,80723709,27954161
0,My Left Foot: The Story of Christy Brown,103,Drama,1989,1134861,25933402,24798541
0,Do the Right Thing,120,Crime|Drama,1989,11433402,65602126,54168724
0,Halloween 5: The Revenge of Michael Myers,96,Horror|Thriller,1989,8794924,20478549,11683625
0,Next of Kin,108,Adventure|Drama|Action|Thriller,1989,21107819,28042842,6935023
0,Road House,114,Action|Thriller,1989,26384774,52857546,26472772
0,Fletch Lives,95,Comedy|Crime|Mystery,1989,14152370,61830009,47677639
0,Three Fugitives,96,Comedy,1989,26384774,71397198,45012424
0,Valmont,137,Drama|Romance,1989,58046502,1991367,-56055135
0,Drugstore Cowboy,100,Crime|Drama,1989,4397462,8318858,3921396
0,The Wizard,100,Adventure|Comedy|Drama|Family|Romance,1989,10553909,25116370,14562461
0,Little Monsters,102,Adventure|Fantasy|Comedy|Family,1989,12312894,1396238,-10916656
3,Beauty and the Beast,84,Romance|Family|Animation|Fantasy|Music,1991,40027321,604173269,564145948
3,Terminator 2: Judgment Day,137,Action|Thriller|Science Fiction,1991,160109284,832568277,672458993
2,Hook,144,Adventure|Fantasy|Comedy|Family,1991,112076498,481696503,369620005
1,Robin Hood: Prince of Thieves,143,Adventure|Drama|Action|Romance,1991,76852456,625217000,548364544
1,Highlander II: The Quickening,91,Action|Fantasy|Science Fiction,1991,48032785,24907144,-23125641
1,Cape Fear,128,Crime|Thriller,1991,56038249,291879225,235840976
1,Star Trek VI: The Undiscovered Country,113,Science Fiction|Action|Adventure|Thriller,1991,43229506,155145896,111916390
1,The Naked Gun 2Â½: The Smell of Fear,85,Action|Comedy|Crime,1991,36825135,139183658,102358523
1,Point Break,120,Action|Thriller|Crime,1991,38426228,133742420,95316192
1,Backdraft,137,Action|Crime|Drama|Mystery|Thriller,1991,120081963,243956250,123874287
0,The Addams Family,99,Comedy|Family|Fantasy,1991,48032785,306613163,258580378
0,Hudson Hawk,100,Action|Adventure|Comedy,1991,104071034,27567744,-76503290
0,The Rocketeer,108,Action|Adventure|Science Fiction|Family,1991,67245899,99267756,32021857
0,Thelma & Louise,130,Drama|Thriller|Crime|Adventure,1991,25617485,72627172,47009687
0,The Doors,140,Drama|Music,1991,60841527,55104641,-5736886
0,Teenage Mutant Ninja Turtles II: The Secret of the Ooze,88,Science Fiction|Adventure|Action|Comedy|Family,1991,40027321,124,-40027197
0,Nothing but Trouble,94,Comedy|Adventure,1991,64043713,13576935,-50466778
0,The Silence of the Lambs,118,Crime|Drama|Thriller,1991,30420764,436686740,406265976
0,Barton Fink,116,Comedy|Drama,1991,14409835,9853027,-4556808
0,Freddy's Dead: The Final Nightmare,89,Horror|Thriller|Comedy,1991,17612021,55833362,38221341
0,The Last Boy Scout,105,Adventure|Action|Comedy|Thriller,1991,46431692,95280914,48849222
0,JFK,189,Drama|Thriller|History,1991,64043713,328873272,264829559
0,Boyz n the Hood,112,Crime|Drama,1991,10407103,92069353,81662250
0,Harley Davidson and the Marlboro Man,98,Action|Thriller,1991,36825135,11903686,-24921449
0,Double Impact,110,Thriller|Action|Crime|Drama,1991,24016392,48197244,24180852
0,What About Bob?,100,Comedy,1991,56038249,102005625,45967376
0,Child's Play 3,90,Horror,1991,20814206,32918877,12104671
0,City Slickers,112,Action|Adventure|Comedy|Drama|Western,1991,41628413,198589614,156961201
0,Hot Shots!,84,Action|Comedy|War,1991,41628413,289951771,248323358
0,Return to the Blue Lagoon,98,Drama|Adventure|Romance,1991,17612021,4495634,-13116387
0,Fried Green Tomatoes,130,Drama|Comedy,1991,17612021,191200107,173588086
0,Showdown in Little Tokyo,79,Action|Thriller,1991,12808742,3643378,-9165364
0,Sleeping with the Enemy,99,Crime|Thriller,1991,30420764,280189654,249768890
0,Rock-A-Doodle,77,Comedy|Family|Animation|Fantasy|Music,1991,28819671,18664555,-10155116
0,The Fisher King,137,Drama|Comedy,1991,38426228,67078570,28652342
0,Don't Tell Mom the Babysitter's Dead,105,Comedy|Family,1991,16010928,40341533,24330605
0,Shadows and Fog,85,Thriller|Comedy,1991,22415299,4380159,-18035140
0,Bugsy,134,Drama|Crime,1991,48032785,78636099,30603314
0,Cool as Ice,91,Drama|Action|Comedy|Music|Romance,1991,9606557,1910203,-7696354
0,Out for Justice,91,Action|Thriller|Crime,1991,22415299,63520414,41105115
0,The Prince of Tides,132,Drama|Romance,1991,48032785,119741889,71709104
0,Jungle Fever,132,Drama|Romance,1991,22415299,52007789,29592490
0,New Jack City,97,Thriller|Crime|Drama,1991,13609289,76250850,62641561
0,A Rage in Harlem,115,Crime|Comedy,1991,12808742,16651365,3842623
0,Oscar,109,Action|Comedy|Thriller|Family,1991,56038249,37726095,-18312154
0,Mobsters,104,Drama|Action|Thriller|Crime,1991,36825135,32416990,-4408145
0,Shattered,98,Mystery|Thriller,1991,35224042,18430229,-16793813
0,White Fang,107,Action|Adventure|Drama|Family,1991,22415299,55707079,33291780
0,Dutch,107,Comedy,1991,27218578,7371317,-19847261
0,Mannequin Two: On the Move,95,Fantasy|Comedy|Science Fiction|Romance,1991,20814206,6007982,-14806224
3,Die Hard,131,Action|Thriller,1988,51628948,259560770,207931822
2,Big,104,Fantasy|Drama|Comedy|Romance|Family,1988,33190038,279660690,246470652
1,The Naked Gun: From the Files of Police Squad!,85,Action|Comedy|Crime,1988,22126692,145217807,123091115
1,License to Drive,90,Comedy|Family,1988,14751128,41364514,26613386
1,Beetlejuice,92,Fantasy|Comedy,1988,27658365,135206381,107548016
1,Rain Man,133,Drama,1988,46097275,654259434,608162159
1,Bloodsport,92,Action,1988,2765836,21769196,19003360
1,Coming to America,116,Comedy|Romance,1988,71911749,532427775,460516026
1,Rambo III,102,Action|Adventure|Thriller|War,1988,116165134,348524188,232359054
1,Twins,107,Comedy|Drama,1988,27658365,399413325,371754960
1,Who Framed Roger Rabbit,104,Fantasy|Animation|Comedy|Crime|Family,1988,129072371,608122557,479050186
1,The Land Before Time,69,Animation|Adventure|Family,1988,22679859,155736595,133056736
1,Cocktail,104,Drama|Romance,1988,36877820,316236126,279358306
0,Child's Play,87,Horror|Thriller,1988,16595019,81493868,64898849
0,Willow,126,Adventure|Drama|Action,1988,64536185,105599386,41063201
0,A Nightmare on Elm Street 4: The Dream Master,99,Horror|Thriller,1988,12907237,133682099,120774862
0,Bull Durham,108,Comedy|Romance,1988,12907237,93831926,80924689
0,Red Heat,104,Comedy|Action|Crime,1988,53472839,64526317,11053478
0,A Fish Called Wanda,108,Comedy|Crime,1988,13829182,115231594,101402412
0,The Blob,95,Horror|Science Fiction,1988,35033929,15208308,-19825621
0,Cocoon: The Return,116,Comedy|Drama|Science Fiction,1988,32268092,46143223,13875131
0,Mississippi Burning,128,Thriller|Crime|Drama,1988,27658365,63806004,36147639
0,Working Girl,114,Comedy|Drama|Romance,1988,51628948,190240939,138611991
0,They Live,94,Action|Horror|Science Fiction|Thriller,1988,7375564,23987045,16611481
0,Phantasm II,97,Action|Horror|Science Fiction|Thriller,1988,5531673,13428783,7897110
0,Halloween 4: The Return of Michael Myers,88,Horror|Thriller,1988,9219455,32763651,23544196
0,Action Jackson,96,Action|Adventure|Comedy|Crime|Drama,1988,12907237,37351654,24444417
0,Married to the Mob,104,Action|Comedy|Thriller|Crime|Romance,1988,18438910,39619238,21180328
0,Friday the 13th Part VII: The New Blood,88,Horror|Thriller,1988,5162894,35347392,30184498
0,Dangerous Liaisons,119,Drama|Romance,1988,25814474,63929029,38114555
0,My Stepmother is an Alien,108,Comedy|Science Fiction,1988,36877820,25545266,-11332554
0,Frantic,120,Thriller|Action|Crime|Drama|Mystery,1988,36877820,32522457,-4355363
0,Return of the Living Dead Part II,89,Comedy|Horror,1988,11432124,16974720,5542596
0,Poltergeist III,98,Horror|Thriller,1988,19360855,26079994,6719139
0,Midnight Run,126,Adventure|Comedy|Crime,1988,55316730,70830503,15513773
0,Above the Law,99,Action|Adventure|Drama|Thriller,1988,13829182,34793543,20964361
0,The Last Temptation of Christ,164,Drama,1988,12907237,15439978,2532741
0,Prison,102,Crime|Drama|Horror|Thriller,1988,2397058,654035,-1743023
0,The Great Outdoors,91,Comedy,1988,44253384,80126708,35873324
0,Dead Ringers,115,Drama|Horror|Thriller,1988,23970583,14822132,-9148451
0,Ernest Saves Christmas,95,Comedy|Family,1988,11063346,52001615,40938269
0,Bad Dreams,86,Horror|Thriller,1988,7375564,18064781,10689217
0,Night of the Demons,90,Horror,1988,2212669,5734324,3521655
0,Talk Radio,110,Drama,1988,7375564,6395668,-979896
0,Earth Girls Are Easy,100,Music|Comedy|Drama|Romance|Science Fiction,1988,18438910,7221235,-11217675
0,Punchline,123,Comedy|Drama,1988,27658365,38781208,11122843
0,Critters 2,86,Thriller|Comedy|Horror|Science Fiction,1988,8297509,7031296,-1266213
0,Monkey Shines,113,Thriller|Drama|Horror|Science Fiction,1988,12907237,9854817,-3052420
0,Powaqqatsi,99,Documentary|Drama|Music,1988,4609727,1086501,-3523226
0,The Serpent and the Rainbow,98,Horror|Thriller,1988,12907237,36131101,23223864
0,Colors,120,Action|Crime|Drama,1988,11063346,85954947,74891601
0,Biloxi Blues,106,Comedy|Drama|Romance,1988,36877820,95301135,58423315
0,Vampire's Kiss,103,Comedy|Fantasy|Horror,1988,3687782,1337062,-2350720
0,The Lair of the White Worm,93,Comedy|Horror,1988,4609727,2192967,-2416760
0,A Cry in the Dark,120,Drama|Foreign,1988,27658365,12739068,-14919297
0,Red Scorpion,105,Action|History|War,1988,29502256,7730402,-21771854
0,The New Adventures of Pippi Longstocking,100,Fantasy|Adventure|Family,1988,9219455,6582578,-2636877
3,Predator,107,Science Fiction|Action|Adventure|Thriller,1987,34543447,188521918,153978471
2,Full Metal Jacket,116,Drama|War,1987,32624367,88964109,56339742
1,Dirty Dancing,100,Drama|Music|Romance,1987,11514482,410595461,399080979
1,Spaceballs,96,Comedy|Science Fiction,1987,43563125,73154354,29591229
1,The Living Daylights,130,Action|Adventure|Thriller,1987,76763217,366901115,290137898
1,RoboCop,102,Action|Thriller|Science Fiction,1987,24948045,101711263,76763218
1,Evil Dead II,84,Horror|Comedy|Fantasy,1987,6908689,11366797,4458108
1,Lethal Weapon,110,Adventure|Action|Comedy|Thriller|Crime,1987,28786206,230687145,201900939
1,The Running Man,101,Action|Science Fiction,1987,51815171,73159385,21344214
1,Jaws: The Revenge,89,Adventure|Thriller,1987,44138850,99563837,55424987
1,The Princess Bride,98,Adventure|Family|Fantasy|Comedy|Romance,1987,30705287,59218627,28513340
1,A Nightmare on Elm Street 3: Dream Warriors,96,Horror|Thriller,1987,9595402,85961796,76366394
1,Wall Street,126,Crime|Drama,1987,28786206,84147971,55361765
1,Beverly Hills Cop II,100,Action|Comedy|Crime,1987,38381608,575657032,537275424
1,Superman IV: The Quest for Peace,90,Action|Adventure|Fantasy|Science Fiction|Thriller,1987,32624367,37038252,4413885
1,Raising Arizona,94,Comedy|Crime,1987,11514482,55999304,44484822
1,The Untouchables,119,Crime|Drama|History|Thriller,1987,47977010,146369136,98392126
1,"Good Morning, Vietnam",121,Comedy|Drama|War,1987,24948045,237816996,212868951
0,The Last Emperor,163,Drama|History,1987,44138850,84409275,40270425
0,Fatal Attraction,119,Horror|Drama|Romance|Thriller,1987,26867126,614385336,587518210
0,Angel Heart,113,Horror|Mystery|Thriller,1987,32624367,32980610,356243
0,Over the Top,93,Action|Drama,1987,47977010,30815787,-17161223
0,The Lost Boys,97,Comedy|Horror,1987,16312183,61837697,45525514
0,Creepshow 2,92,Horror,1987,6716781,26867126,20150345
0,Overboard,106,Comedy|Romance,1987,3607882,51264754,47656872
0,Barfly,100,Comedy|Drama|Romance,1987,5757241,6182448,425207
0,Broadcast News,133,Comedy|Drama|Romance,1987,38381608,98351728,59970120
0,Blind Date,95,Comedy|Romance,1987,34543447,75461534,40918087
0,Dragnet,106,Action|Comedy|Crime,1987,38381608,127951840,89570232
0,The Pick-up Artist,81,Romance|Comedy|Crime|Drama,1987,28786206,25505285,-3280921
0,Cherry 2000,99,Science Fiction,1987,19190804,26867,-19163937
0,No Way Out,114,Crime|Drama|Action|Thriller|Mystery,1987,28786206,68145615,39359409
0,The Secret of My Success,111,Comedy,1987,23028965,213011939,189982974
0,Three Men and a Baby,102,Family|Comedy|Drama,1987,21109884,322405513,301295629
0,Prince of Darkness,101,Horror,1987,5757241,27217342,21460101
0,Hellraiser,94,Horror,1987,1919080,27949539,26030459
0,Mio min Mio,99,Adventure|Drama|Fantasy|Family|Mystery,1987,13817379,4413885,-9403494
0,La Bamba,108,Drama|Music,1987,12474022,104043744,91569722
0,Someone to Watch Over Me,106,Crime|Drama|Romance|Thriller,1987,32624367,19725362,-12899005
0,Project X,108,Action|Comedy|Drama|Science Fiction,1987,34543447,35564947,1021500
0,Throw Momma from the Train,88,Crime|Comedy,1987,26867126,111145408,84278282
0,The Monster Squad,82,Horror|Comedy|Action|Fantasy|Science Fiction,1987,23028965,7234914,-15794051
0,Can't Buy Me Love,94,Drama|Comedy|Romance|Family,1987,3454344,60688679,57234335
0,Mannequin,89,Fantasy|Comedy|Romance,1987,11514482,81985411,70470929
0,Ernest Goes to Camp,92,Comedy|Family,1987,5757241,45116395,39359154
0,"Silent Night, Deadly Night Part 2",88,Comedy|Horror,1987,479770,296158,-183612
3,2001: A Space Odyssey,149,Science Fiction|Mystery|Adventure,1968,75227563,355546597,280319034
1,Planet of the Apes,112,Adventure|Science Fiction|Mystery,1968,36359988,209354710,172994722
0,Bullitt,113,Action|Crime|Drama|Thriller,1968,34479299,265182633,230703334
0,Rosemary's Baby,136,Horror|Drama|Mystery,1968,20060683,209354710,189294027
0,Oliver!,153,Drama|Family|Music,1968,62689636,105318588,42628952
0,Hang 'em High,114,Western,1968,11284134,42628952,31344818
0,Where Eagles Dare,155,Adventure|Drama|Action|History|War,1968,48271019,131648235,83377216
0,The Green Berets,142,War|Drama,1968,43882745,68958599,25075854
0,Charly,103,Drama|Romance|Science Fiction,1968,5955515,5107111,-848404
3,The Godfather: Part II,200,Drama|Crime,1974,57489690,210247939,152758249
1,Chinatown,130,Crime|Drama|Mystery|Thriller,1974,26533703,132668516,106134813
1,The Man with the Golden Gun,125,Adventure|Action|Thriller,1974,30955987,431491083,400535096
1,Young Frankenstein,106,Comedy|Science Fiction,1974,12382394,381525170,369142776
0,The Texas Chain Saw Massacre,83,Horror|Thriller,1974,375894,136467258,136091364
0,The Conversation,113,Crime|Drama|Mystery,1974,7075654,19546494,12470840
0,Blazing Saddles,93,Comedy|Western,1974,11497938,528462924,516964986
0,Airport 1975,107,Action|Adventure|Drama|Thriller,1974,13266851,207847342,194580491
0,The Sugarland Express,110,Action|Crime|Drama,1974,13266851,56605233,43338382
0,The Great Gatsby,144,Drama|Romance,1974,28744845,117337342,88592497
0,Death Wish,93,Action|Crime|Drama|Thriller,1974,13266851,97290245,84023394
0,The Towering Inferno,159,Action|Thriller,1974,61911974,512984931,451072957
0,Earthquake,123,Action|Drama|Thriller,1974,30955987,352308556,321352569
3,One Flew Over the Cuckoo's Nest,133,Drama,1975,12155463,441572637,429417174
2,Jaws,124,Horror|Thriller|Adventure,1975,28362748,1907005842,1878643094
2,Monty Python and the Holy Grail,91,Adventure|Comedy|Fantasy,1975,1620728,20376397,18755669
1,The Rocky Horror Picture Show,100,Comedy|Horror|Music|Science Fiction,1975,4862185,457419488,452557303
1,Barry Lyndon,184,Drama|Romance|War,1975,44570032,81036423,36466391
0,The Return of the Pink Panther,113,Comedy,1975,20259105,169501241,149242136
0,Hard Times,93,Drama,1975,10939917,20259105,9319188
0,Tommy,111,Drama|Music,1975,20259105,138781054,118521949
0,Dog Day Afternoon,125,Crime|Drama|Thriller,1975,7293278,189081703,181788425
3,Dr. No,110,Adventure|Action|Thriller,1962,7929293,429623553,421694260
1,Lawrence of Arabia,216,Adventure|Drama|History|War,1962,108126733,504591421,396464688
0,To Kill a Mockingbird,129,Crime|Drama,1962,14416897,94645823,80228926
0,How the West Was Won,162,Western|Action|Adventure|Drama,1962,108126733,360422443,252295710
0,The Man Who Shot Liberty Valance,123,Western,1962,23067036,57667591,34600555
0,Birdman of Alcatraz,143,Drama,1962,19102389,22346191,3243802
0,The Miracle Worker,106,Drama,1962,3604224,18021122,14416898
3,Goldfinger,110,Adventure|Action|Thriller,1964,24605935,878080399,853474464
2,Dr. Strangelove or: How I Learned to Stop Worrying and Love the Bomb,95,Drama|Comedy|War,1964,12654481,66367636,53713155
1,Mary Poppins,139,Comedy|Music|Family|Fantasy,1964,42181604,719004619,676823015
0,A Hard Day's Night,88,Comedy|Music,1964,3515133,7034127,3518994
0,Marnie,130,Crime|Drama|Mystery|Thriller,1964,15010752,49211871,34201119
0,My Fair Lady,170,Drama|Family|Music|Romance,1964,119514546,506179253,386664707
0,The Night of the Iguana,125,Drama|Romance,1964,21090802,84363208,63272406
3,A Clockwork Orange,136,Science Fiction|Drama,1971,11847428,143186947,131339519
2,Willy Wonka & the Chocolate Factory,100,Family|Fantasy,1971,16155584,21540779,5385195
1,Diamonds Are Forever,120,Adventure|Action|Thriller|Science Fiction,1971,38773403,624682610,585909207
0,Dirty Harry,102,Action|Crime|Thriller,1971,21540779,193737772,172196993
0,Escape from the Planet of the Apes,98,Action|Science Fiction,1971,13462987,66501260,53038273
0,Straw Dogs,118,Crime|Drama|Thriller|Mystery,1971,11847428,17511544,5664116
0,THX 1138,86,Drama|Mystery|Science Fiction|Thriller,1971,4184296,13123720,8939424
0,The French Connection,104,Action|Crime|Thriller,1971,9693350,221647928,211954578
0,Play Misty for Me,102,Crime|Drama|Romance|Thriller,1971,3904266,57083066,53178800
0,Shaft,100,Adventure|Action|Thriller|Crime,1971,21540779,65277275,43736496
0,Fiddler on the Roof,181,Drama|Music|Romance,1971,48466754,56029345,7562591
0,The Last Picture Show,118,Drama,1971,7000753,156886883,149886130
0,Vanishing Point,99,Action|Thriller|Drama,1971,7000753,389168143,382167390
2,Total Recall,113,Action|Adventure|Science Fiction,1990,108478405,436113096,327634691
2,Goodfellas,146,Drama|Crime,1990,41722463,78165189,36442726
2,Die Hard 2,124,Action|Thriller,1990,116822897,400587542,283764645
2,Back to the Future Part III,118,Adventure|Action|Comedy|Science Fiction|Family,1990,66755941,408091726,341335785
2,Edward Scissorhands,105,Fantasy|Drama|Romance,1990,33377970,88451622,55073652
2,Pretty Woman,119,Romance|Comedy,1990,23364579,772700024,749335445
1,The Godfather: Part III,162,Drama|Action|Thriller|Crime,1990,90120521,228248681,138128160
1,Dances with Wolves,181,Adventure|Drama|Western,1990,36715767,707961527,671245760
1,Ghost,127,Fantasy|Drama|Thriller|Mystery|Romance,1990,36715767,842793762,806077995
1,Teenage Mutant Ninja Turtles,93,Science Fiction|Action|Adventure|Comedy|Family,1990,22530130,337060620,314530490
1,Misery,107,Horror|Thriller,1990,33377970,102264882,68886912
1,Rocky V,104,Drama,1990,70093738,200178301,130084563
1,Child's Play 2,84,Drama|Horror,1990,21695681,59685828,37990147
1,The Hunt for Red October,134,Action|Adventure|Thriller,1990,50,333,283
1,Predator 2,108,Science Fiction|Action|Thriller,1990,58411448,95328015,36916567
1,Days of Thunder,107,Adventure,1990,100133912,263553680,163419768
0,Miller's Crossing,115,Drama|Thriller|Crime,1990,23364579,8478687,-14885892
0,Gremlins 2: The New Batch,106,Comedy|Horror|Fantasy,1990,83444927,69229594,-14215333
0,Tremors,96,Action|Horror,1990,18357883,81061739,62703856
0,RoboCop 2,117,Action|Adventure|Crime|Science Fiction|Thriller,1990,58411448,76237242,17825794
0,The Neverending Story II: The Next Chapter,89,Drama|Family|Fantasy|Adventure,1990,53404753,27175788,-26228965
0,Another 48 Hrs.,95,Thriller|Action|Comedy|Crime|Drama,1990,63418144,256207591,192789447
0,Lionheart,105,Action|Thriller,1990,10013391,40184066,30170675
0,Death Warrant,93,Action|Crime|Drama|Mystery|Thriller,1990,6675594,28126759,21451165
0,Wild at Heart,124,Comedy|Crime|Thriller,1990,15854536,24299574,8445038
0,Flatliners,115,Drama|Horror|Science Fiction|Thriller,1990,43391362,102619344,59227982
0,Jacob's Ladder,113,Drama|Mystery|Horror,1990,41722463,43333190,1610727
0,Cry-Baby,85,Music|Comedy,1990,18357883,13795687,-4562196
0,Mo' Better Blues,129,Drama|Romance,1990,16688985,26958707,10269722
0,Dark Angel,91,Action|Thriller|Science Fiction|Crime|Horror,1990,11682289,15402933,3720644
0,Dick Tracy,103,Adventure|Action|Comedy|Thriller|Crime,1990,78438231,173129408,94691177
0,Darkman,96,Action|Science Fiction|Crime,1990,26702376,81573260,54870884
0,Night of the Living Dead,88,Horror,1990,7009373,9738435,2729062
0,The Bonfire of the Vanities,125,Comedy|Drama,1990,78438231,26187007,-52251224
0,Marked for Death,94,Action|Thriller,1990,20026782,76843431,56816649
0,Kindergarten Cop,111,Comedy,1990,25033478,337046890,312013412
0,King of New York,103,Thriller|Crime,1990,1668898,4263161,2594263
0,Graveyard Shift,89,Drama|Horror,1990,17523434,19330669,1807235
0,The Sheltering Sky,138,Adventure|Drama|Romance,1990,41722463,3463104,-38259359
0,Hardware,93,Horror|Science Fiction|Thriller,1990,2503347,9561041,7057694
0,Tales from the Darkside: The Movie,93,Fantasy|Horror|Comedy,1990,5,26,21
0,Hard to Kill,96,Action|Thriller,1990,16688985,79122479,62433494
0,The Rescuers Down Under,77,Adventure|Animation|Crime|Family|Fantasy,1990,63302990,46614774,-16688216
0,Frankenhooker,85,Comedy|Horror|Science Fiction,1990,4172246,342237,-3830009
0,Nightbreed,102,Action|Drama|Fantasy|Horror,1990,18357883,14790369,-3567514
0,The Two Jakes,138,Crime|Drama|Mystery,1990,31709072,16688985,-15020087
0,The Adventures of Ford Fairlane,104,Action|Comedy|Thriller|Crime|Mystery,1990,81776028,34084564,-47691464
0,Mr. Destiny,110,Fantasy|Comedy|Science Fiction|Romance,1990,33377970,25666412,-7711558
0,Postcards from the Edge,101,Comedy|Drama,1990,36715767,65206541,28490774
0,Paris is Burning,71,Documentary,1990,834449,6307802,5473353
0,Home Alone,103,Comedy|Family,1990,30040173,795538358,765498185
0,Mermaids,110,Comedy|Drama|Romance,1990,51735854,59111379,7375525
0,House Party,100,Comedy|Drama,1990,4172246,44035556,39863310
2,One Hundred and One Dalmatians,79,Adventure|Animation|Comedy|Family,1961,29179444,1574814740,1545635296
1,Breakfast at Tiffany's,110,Comedy|Drama|Romance,1961,18237153,69301181,51064028
0,West Side Story,152,Music|Crime|Drama,1961,43769167,318470457,274701290
0,The Guns of Navarone,158,Action|Adventure|Drama|War,1961,43769167,210821488,167052321
0,Judgment at Nuremberg,186,Drama|History,1961,21884583,72948612,51064029
0,King of Kings,168,Drama,1961,36744215,105654042,68909827
0,The Pit and the Pendulum,80,Horror,1961,1458972,14589722,13130750
0,One-Eyed Jacks,141,Western|Action,1961,43769167,31367903,-12401264
0,"One, Two, Three",115,Comedy|Family,1961,21884583,29179444,7294861
0,Pocketful of Miracles,136,Comedy|Drama,1961,21155097,36474306,15319209
2,Psycho,109,Drama|Horror|Thriller,1960,5949601,235934958,229985357
1,The Magnificent Seven,128,Action|Adventure|Western,1960,14745934,36164405,21418471
1,Spartacus,197,Action|Drama|History,1960,88475609,442378047,353902438
0,The Apartment,125,Comedy|Drama|Romance,1960,22118902,184324186,162205284
0,Cinderfella,91,Comedy|Romance,1960,22118902,52348068,30229166
2,Taxi Driver,113,Crime|Drama,1976,4981207,108293649,103312442
2,Rocky,119,Drama,1976,4214867,449209681,444994814
1,Carrie,98,Horror|Thriller,1976,6897056,129511393,122614337
0,The Omen,111,Horror|Thriller,1976,10728754,233438462,222709708
0,Logan's Run,120,Adventure|Action|Romance|Science Fiction,1976,34485282,95792450,61307168
0,King Kong,134,Action|Adventure|Drama|Horror|Science Fiction,1976,91960752,201602665,109641913
0,All the President's Men,138,Drama|History|Mystery|Thriller,1976,32569433,270517880,237948447
0,The Enforcer,96,Action|Crime|Thriller,1976,34485282,177162390,142677108
0,Family Plot,121,Comedy|Crime|Thriller,1976,7663396,30270414,22607018
0,The Outlaw Josey Wales,135,Drama|Western,1976,14177282,121847997,107670715
0,Marathon Man,125,Thriller,1976,24906037,83182409,58276372
0,Network,121,Drama,1976,14560452,90772455,76212003
0,The Pink Panther Strikes Again,103,Comedy|Mystery,1976,22990188,129638609,106648421
0,A Star Is Born,139,Drama|Music|Romance,1976,22990188,616903382,593913194
0,The Bad News Bears,102,Comedy|Family,1976,134109431,135348188,1238757
2,Groundhog Day,101,Romance|Fantasy|Drama|Comedy,1993,22038261,107031945,84993684
2,The Nightmare Before Christmas,76,Fantasy|Animation|Family,1993,27170459,114167868,86997409
2,Schindler's List,195,Drama|History|War,1993,33208339,484941026,451732687
2,Jurassic Park,127,Adventure|Science Fiction,1993,95096607,1388863312,1293766705
1,Demolition Man,115,Action|Adventure|Comedy|Science Fiction,1993,86039787,240089904,154050117
1,Mrs. Doubtfire,125,Comedy|Drama|Family,1993,37736749,666108255,628371506
1,The Fugitive,130,Adventure|Action|Thriller|Crime|Mystery,1993,66416678,556806879,490390201
1,In the Line of Fire,128,Action|Drama|Thriller|Crime|Mystery,1993,60378798,267171908,206793110
1,Philadelphia,125,Drama|Mystery,1993,39246219,311974896,272728677
1,Dazed and Confused,102,Comedy|Drama,1993,10415342,12065252,1649910
1,Last Action Hero,130,Adventure|Fantasy|Action|Comedy|Family,1993,128304946,207247944,78942998
1,A Perfect World,138,Crime|Drama|Thriller,1993,45284098,203976183,158692085
1,Robin Hood: Men in Tights,104,Comedy,1993,30189399,53948086,23758687
1,Cliffhanger,112,Action|Adventure|Thriller,1993,105662897,384915158,279252261
1,Sliver,108,Drama|Thriller,1993,60378798,175551356,115172558
1,Teenage Mutant Ninja Turtles III,96,Action|Adventure|Comedy|Family|Fantasy,1993,31,63,32
0,Cool Runnings,98,Comedy,1993,21132579,233763161,212630582
0,Sleepless in Seattle,105,Comedy|Drama|Romance,1993,31698869,343857082,312158213
0,Tombstone,130,Action|Adventure|Drama|History|Western,1993,37736749,85292698,47555949
0,For Love or Money,94,Comedy|Romance,1993,45284098,16824959,-28459139
0,Carlito's Way,144,Action|Crime|Drama|Thriller,1993,45284098,55119823,9835725
0,Hot Shots! Part Deux,86,Action|Comedy|War,1993,37736749,201895871,164159122
0,True Romance,120,Action|Thriller|Crime|Romance,1993,18868374,18538632,-329742
0,Super Mario Bros.,104,Adventure|Comedy|Family|Fantasy,1993,63397738,31464760,-31932978
0,Sister Act 2: Back in the Habit,107,Music|Comedy,1993,57359858,86521352,29161494
0,The Pelican Brief,141,Action|Mystery|Thriller,1993,67926148,294751265,226825117
0,The Three Musketeers,105,Action|Adventure|Comedy,1993,45284098,81358687,36074589
0,RoboCop 3,104,Action|Adventure|Crime|Science Fiction|Thriller,1993,33208339,16145607,-17062732
0,What's Eating Gilbert Grape,118,Romance|Drama,1993,16604169,45284098,28679929
0,Dennis the Menace,94,Family|Comedy,1993,52831448,177016697,124185249
0,Kalifornia,117,Thriller|Crime,1993,13585229,3615529,-9969700
0,A Bronx Tale,121,Drama|Crime,1993,33208339,26095562,-7112777
0,Manhattan Murder Mystery,104,Comedy|Crime|Mystery|Thriller,1993,20377844,17035256,-3342588
0,Falling Down,113,Crime|Drama|Thriller,1993,37736749,61742744,24005995
0,The Firm,154,Drama|Mystery|Thriller,1993,63397738,407931792,344534054
0,The Dark Half,122,Mystery|Horror,1993,22642049,16017227,-6624822
0,Hocus Pocus,96,Comedy|Family|Fantasy,1993,42265158,59646272,17381114
0,In the Name of the Father,133,Drama,1993,19623109,99318386,79695277
0,Body Snatchers,87,Horror|Science Fiction|Thriller,1993,19623109,647363,-18975746
0,Free Willy,112,Family|Adventure,1993,30189399,232003457,201814058
0,The Piano,121,Romance|Drama,1993,10566289,176155144,165588855
0,Geronimo: An American Legend,115,Action|Drama|Western,1993,52831448,28129908,-24701540
0,The Good Son,87,Drama|Horror|Thriller,1993,25660989,67105718,41444729
0,Hard Target,97,Action|Adventure|Crime|Thriller,1993,27170459,111987088,84816629
0,The Remains of the Day,134,Drama|Romance,1993,17358904,35076928,17718024
0,Batman: Mask of the Phantasm,76,Animation|Action|Adventure|Family,1993,9056819,8479282,-577537
0,The Age of Innocence,139,Drama|Romance,1993,51321978,48688617,-2633361
0,Alive,120,Action|Adventure|Drama|Thriller,1993,48303038,55448732,7145694
0,Jason Goes to Hell: The Final Friday,87,Horror|Thriller,1993,4528409,22,-4528387
0,National Lampoon's Loaded Weapon 1,84,Comedy,1993,12,40,28
0,Rudy,114,Drama,1993,18113639,34340989,16227350
0,Beethoven's 2nd,89,Family|Comedy,1993,22642049,178484356,155842307
0,So I Married an Axe Murderer,93,Comedy|Crime|Romance,1993,30189399,17487938,-12701461
0,The House of the Spirits,140,Romance|Drama,1993,37736749,9,-37736740
0,Indecent Proposal,117,Drama,1993,57359858,402445913,345086055
0,Menace II Society,97,Drama|Action|Crime,1993,5283144,42114211,36831067
0,Body of Evidence,99,Drama|Thriller|Romance,1993,45284098,20036092,-25248006
0,Red Rock West,98,Crime|Drama|Thriller,1993,12075759,3018939,-9056820
0,Leprechaun,92,Comedy|Horror|Thriller,1993,1358522,12916443,11557921
0,Son of the Pink Panther,93,Comedy|Foreign,1993,37736749,3680134,-34056615
0,Little Buddha,140,Drama|History,1993,52831448,7333214,-45498234
0,Killing Zoe,96,Action|Crime|Drama|Thriller,1993,2264204,632409,-1631795
0,Poetic Justice,109,Drama|Romance,1993,21132579,41534252,20401673
0,Children of the Corn II: The Final Sacrifice,92,Horror|Mystery,1993,1358522,10537588,9179066
0,The Joy Luck Club,139,Drama,1993,16604169,49602897,32998728
0,The Crush,89,Drama|Thriller,1993,9056819,20542974,11486155
0,Fire in the Sky,109,Drama|Horror|Thriller|Mystery,1993,30016643,29773289,-243354
0,Only the Strong,99,Action,1993,9056819,4956149,-4100670
0,Man's Best Friend,97,Horror|Science Fiction|Thriller,1993,9056819,19584823,10528004
0,Dragon: The Bruce Lee Story,120,Drama|Action,1993,21132579,95872087,74739508
0,Return of the Living Dead 3,97,Horror|Romance|Science Fiction,1993,3018939,81823,-2937116
0,Xi yan,109,Comedy|Drama|Romance,1993,1509469,10465848,8956379
2,The Jungle Book,78,Family|Animation|Adventure,1967,26147054,1345551059,1319404005
2,The Graduate,106,Comedy|Drama|Romance,1967,19610291,682419190,662808899
1,Casino Royale,131,Adventure|Action|Comedy,1967,78441164,272875359,194434195
1,You Only Live Twice,117,Action|Thriller|Adventure,1967,62099255,729403389,667304134
1,Bonnie and Clyde,111,Crime|Drama,1967,16341909,331413921,315072012
0,Cool Hand Luke,126,Crime|Drama,1967,19610291,106011750,86401459
0,Wait Until Dark,108,Crime|Drama|Thriller,1967,26147054,71904401,45757347
0,The Dirty Dozen,150,Action|Adventure|War,1967,163419093,296115397,132696304
0,In the Heat of the Night,109,Crime|Drama|Mystery|Thriller,1967,13073527,178976447,165902920
0,Guess Who's Coming to Dinner,108,Comedy|Drama|Romance,1967,26147054,370416614,344269560
0,Doctor Dolittle,152,Adventure|Fantasy|Comedy|Family|Music,1967,117661747,58830873,-58830874
0,Valley of the Dolls,123,Music|Drama|Romance,1967,32683818,326838187,294154369
0,A Countess from Hong Kong,120,Comedy|Romance,1967,22878673,13073527,-9805146
2,From Russia With Love,115,Action|Thriller|Adventure,1963,17800448,561773359,543972911
1,The Birds,119,Horror,1963,17800448,81195171,63394723
0,Charade,113,Comedy|Mystery|Romance|Thriller,1963,28480717,95941483,67460766
0,Cleopatra,248,Drama|History|Romance,1963,221544381,411190358,189645977
0,The Great Escape,172,Adventure|Drama|History|Thriller|War,1963,28480717,35600896,7120179
0,55 Days at Peking,154,Action|Drama|History,1963,121043049,71201793,-49841256
2,Aliens,137,Horror|Action|Thriller|Science Fiction,1986,36804018,260732097,223928079
1,Highlander,116,Adventure|Action|Fantasy,1986,31830502,11737497,-20093005
1,Platoon,120,Drama|War|Action,1986,11936438,275593594,263657156
1,Top Gun,110,Drama|Action|Romance,1986,29841096,709881085,680039989
1,Ferris Bueller's Day Off,103,Drama|Comedy,1986,11936438,139529742,127593304
1,Stand by Me,89,Crime|Drama,1986,15915251,104020093,88104842
1,The Fly,96,Horror|Science Fiction,1986,29841096,120616037,90774941
1,Nine 1/2 Weeks,117,Drama|Romance,1986,33819908,13400486,-20419422
1,The Great Mouse Detective,74,Animation,1986,27851689,163976403,136124714
1,Pirates,124,Adventure|Comedy,1986,79576256,3266257,-76309999
0,Blue Velvet,120,Crime|Drama|Mystery|Thriller,1986,11936438,17011867,5075429
0,Star Trek IV: The Voyage Home,119,Science Fiction|Adventure,1986,47745753,264591052,216845299
0,Howard the Duck,110,Fantasy|Comedy|Science Fiction,1986,73608037,75523385,1915348
0,Big Trouble in Little China,99,Adventure|Fantasy|Action|Comedy,1986,49735160,21883470,-27851690
0,The Color of Money,119,Drama,1986,27453808,104033983,76580175
0,The Name of the Rose,130,Drama|Thriller|Mystery,1986,39788128,153582174,113794046
0,Labyrinth,101,Adventure|Family|Fantasy,1986,49735160,25324978,-24410182
0,"The Karate Kid, Part II",113,Adventure|Drama|Action|Romance|Family,1986,224,228988593,228988369
0,Raw Deal,106,Action|Crime|Thriller,1986,16909954,32247201,15337247
0,Crocodile Dundee,97,Adventure|Comedy,1986,9947032,652930158,642983126
0,Heartbreak Ridge,130,Action|Comedy|Drama|War,1986,29841096,84995433,55154337
0,The Golden Child,94,Action|Adventure|Comedy,1986,49735160,158790319,109055159
0,Poltergeist II: The Other Side,91,Thriller|Horror,1986,37798721,81559028,43760307
0,The Money Pit,91,Comedy|Romance,1986,19894064,109416658,89522594
0,Little Shop of Horrors,94,Horror|Comedy|Music,1986,49735160,77086305,27351145
0,The Mission,126,Adventure|Drama|Action|History,1986,48740457,34253645,-14486812
0,Hoosiers,114,Drama|Family,1986,17904657,56911991,39007334
0,Friday the 13th Part VI: Jason Lives,86,Horror|Mystery|Thriller,1986,5968219,38737835,32769616
0,From Beyond,86,Horror|Science Fiction|Fantasy,1986,8952328,2508641,-6443687
0,Critters,82,Comedy|Horror|Science Fiction,1986,3978812,26194975,22216163
0,Sid & Nancy,112,Drama|Music|Romance,1986,7957625,5623102,-2334523
0,Hannah and Her Sisters,107,Comedy|Drama,1986,12732201,79743448,67011247
0,King Kong Lives,105,Action|Horror,1986,19894064,9372531,-10521533
0,Down and Out in Beverly Hills,103,Comedy,1986,27851689,123610225,95758536
0,Maximum Overdrive,97,Action|Drama|Horror|Science Fiction,1986,19894064,14788576,-5105488
0,A Room with a View,117,Drama|Romance,1986,5968219,41711175,35742956
0,Peggy Sue Got Married,103,Comedy|Drama|Fantasy|Romance,1986,35809315,82327289,46517974
0,The Wraith,93,Romance|Science Fiction|Horror|Action|Crime,1986,5371397,6962922,1591525
0,The Texas Chainsaw Massacre 2,101,Horror,1986,9350210,15966721,6616511
0,Invaders from Mars,100,Science Fiction,1986,23872876,9717579,-14155297
0,The Manhattan Project,118,Science Fiction|Thriller,1986,35809315,7758685,-28050630
0,At Close Range,111,Crime|Drama,1986,12931141,4669136,-8262005
0,Troll,82,Fantasy|Horror,1986,2188347,10843886,8655539
0,Armed and Dangerous,88,Action|Comedy|Crime,1986,23872876,31722147,7849271
0,Club Paradise,96,Comedy|Drama|Romance,1986,29841096,24486650,-5354446
0,SpaceCamp,107,Family|Adventure,1986,35809315,19292744,-16516571
0,Vamp,93,Comedy|Horror,1986,3779872,9531098,5751226
0,Manhunter,119,Crime|Horror|Thriller,1986,29841096,17150531,-12690565
2,Robin Hood,83,Animation|Family,1973,73667393,157434425,83767032
2,The Exorcist,122,Drama|Horror|Thriller,1973,39289276,2167324901,2128035625
1,Live and Let Die,121,Adventure|Action|Thriller,1973,34378117,794516768,760138651
1,Mean Streets,110,Drama|Crime,1973,2455579,14733478,12277899
0,Enter the Dragon,99,Crime|Thriller|Action,1973,4174485,442004362,437829877
0,Battle for the Planet of the Apes,93,Action|Science Fiction,1973,8348971,43437217,35088246
0,The Sting,129,Comedy|Crime|Drama,1973,27011377,783901253,756889876
0,American Graffiti,110,Comedy|Drama,1973,3815970,564783351,560967381
0,Papillon,151,Crime|Drama,1973,58933914,261602737,202668823
0,Sleeper,89,Science Fiction|Comedy|Romance,1973,9822319,90093891,80271572
0,Serpico,129,Crime|Drama|History,1973,14733478,146352555,131619077
0,Dillinger,107,Action|Crime|Drama,1973,4911159,9822319,4911160
1,The Aristocats,78,Animation|Comedy|Family|Adventure,1970,22465473,312692751,290227278
0,Beneath the Planet of the Apes,95,Adventure|Science Fiction|Mystery,1970,16849105,106709414,89860309
0,MASH,116,Comedy|Drama|War,1970,19657289,458295656,438638367
0,Patton,172,Drama|History|War,1970,67396420,504349877,436953457
0,Love Story,99,Drama|Romance,1970,12356010,766072642,753716632
0,Tora! Tora! Tora!,144,History|Action|Drama|Adventure|War,1970,143133147,165954086,22820939
0,Airport,137,Action|Drama|Thriller,1970,56163683,564384086,508220403
0,Zabriskie Point,110,Drama|Romance,1970,39314578,5054731,-34259847
0,Little Big Man,139,Action|Comedy|Drama|Western,1970,84245525,177250068,93004543
0,The Ballad of Cable Hogue,121,Action|Comedy|Western,1970,20875737,19657289,-1218448
0,The Private Life of Sherlock Holmes,125,Adventure|Comedy|Crime|Mystery|Romance,1970,56163683,8424552,-47739131
1,Thunderball,130,Adventure|Action|Thriller,1965,76126200,977153544,901027344
1,The Sound of Music,174,Drama|Family|Music|Romance,1965,56748622,1129534862,1072786240
1,Doctor Zhivago,197,Drama|Romance|War,1965,96887891,773178594,676290703
0,Those Magnificent Men in Their Flying Machines or How I Flew from London to Paris in 25 hours 11 minutes,138,Action|Adventure|Comedy,1965,38755156,207270882,168515726
0,The Greatest Story Ever Told,199,Drama|History,1965,138411273,83046764,-55364509
1,On Her Majesty's Secret Service,142,Adventure|Action|Thriller,1969,41609849,487278044,445668195
1,Butch Cassidy and the Sundance Kid,110,History|Drama|Western|Crime,1969,35665585,608151066,572485481
0,Midnight Cowboy,113,Drama,1969,21399351,266214187,244814836
0,The Wild Bunch,145,Adventure|Western,1969,37116502,3796250,-33320252
1,Grease,110,Music,1978,20056204,607749015,587692811
1,Jaws 2,116,Horror|Thriller,1978,66854013,628040000,561185987
1,Dawn of the Dead,127,Horror,1978,2172755,183848538,181675783
1,Superman,143,Adventure|Fantasy|Action|Science Fiction,1978,183848538,1003538977,819690439
1,Halloween,91,Horror|Thriller,1978,1002810,233989048,232986238
1,Animal House,109,Comedy,1978,9025291,471320798,462295507
0,The Deer Hunter,183,Drama|War,1978,50140510,167135034,116994524
0,Midnight Express,121,Drama|Crime,1978,7688211,116994524,109306313
0,The Lord of the Rings,132,Drama|Animation|Adventure,1978,13370802,101856836,88486034
0,Death on the Nile,140,Mystery,1978,26474189,48670002,22195813
0,F.I.S.T.,145,Drama|Action,1978,36,36,0
0,Force 10 from Navarone,118,Action|Adventure|War|Thriller,1978,16713503,24167726,7454223
0,Convoy,110,Action|Comedy|Drama,1978,40112408,76096852,35984444
0,Invasion of the Body Snatchers,115,Horror|Thriller|Science Fiction|Mystery,1978,11699452,80380362,68680910
0,The Wiz,134,Adventure|Family|Fantasy|Music|Science Fiction,1978,80224816,70360684,-9864132
0,Damien: Omen II,107,Action|Drama|Horror|Thriller,1978,22730364,88642923,65912559
0,Watership Down,88,Adventure|Animation|Drama,1978,3342700,12414014,9071314
0,Who's Afraid of Virginia Woolf?,131,Drama,1966,50385110,226643572,176258462
0,Torn Curtain,128,Mystery|Thriller,1966,20154044,87334191,67180147
0,El Dorado,120,Action|Western,1966,31258922,40308088,9049166
0,The Sand Pebbles,182,Action|Adventure|Drama|War|Romance,1966,80616176,134360293,53744117
0,Fantastic Voyage,100,Adventure|Science Fiction,1966,34362645,80616176,46253531
